Chromosome,Start,End,RepeatType,strand,Length
1,1,10000,dust,0,9999
1,10001,10468,trf,0,467
1,10001,10468,(CCCTAA)n,1,467
1,10034,10468,dust,0,434
1,10464,11447,TAR1,-1,983
1,10469,11447,TAR1,-1,978
1,10615,10799,dust,0,184
1,10628,10800,trf,0,172
1,10758,10997,trf,0,239
1,10823,10865,trf,0,42
1,11009,11026,dust,0,17
1,11167,11448,trf,0,281
1,11505,11675,L1MC5a,-1,170
1,11505,11675,L1MC5a,-1,170
1,11678,11780,MER5B,-1,102
1,11678,11780,MER5B,-1,102
1,15265,15355,MIR3,-1,90
1,15265,15355,MIR3,-1,90
1,16713,16744,dust,0,31
1,16713,16749,(TGG)n,1,36
1,18907,19048,L2a,1,141
1,18907,19048,L2a,1,141
1,19306,19443,trf,0,137
1,19972,20405,L3,1,433
1,19972,20405,L3,1,433
1,20531,20679,Plat_L3,1,148
1,20531,20679,Plat_L3,1,148
1,21949,22075,MLT1K,1,126
1,21949,22075,MLT1K,1,126
1,23120,23371,MIR,-1,251
1,23120,23371,MIR,-1,251
1,23804,24038,L2b,1,234
1,23804,24038,L2b,1,234
1,24088,24250,MIR,1,162
1,24088,24250,MIR,1,162
1,24255,24448,L2b,1,193
1,24255,24448,L2b,1,193
1,26356,26412,MIR1_Amn,1,56
1,26356,26412,MIR1_Amn,1,56
1,26583,26790,L2c,-1,207
1,26583,26790,L2c,-1,207
1,26791,27053,AluSp,1,262
1,26791,27053,AluSp,1,262
1,27054,27137,L2c,-1,83
1,27054,27137,L2c,-1,83
1,27269,27518,MER33,1,249
1,27269,27518,MER33,1,249
1,27833,28014,MIRb,-1,181
1,27833,28014,MIRb,-1,181
1,28151,28302,MIR,-1,151
1,28151,28302,MIR,-1,151
1,28412,28420,dust,0,8
1,28589,28603,dust,0,14
1,29222,29283,dust,0,61
1,29902,30198,L1MB3,1,296
1,29902,30198,L1MB3,1,296
1,30189,30262,dust,0,73
1,30343,30532,MER53,-1,189
1,30343,30532,MER53,-1,189
1,30694,30848,MLT1A,1,154
1,30694,30848,MLT1A,1,154
1,30855,30959,dust,0,104
1,30855,30963,trf,0,108
1,30855,30952,(TC)n,1,97
1,30863,30953,trf,0,90
1,30953,31131,MLT1A,1,178
1,30953,31131,MLT1A,1,178
1,31293,31435,MIRc,1,142
1,31293,31435,MIRc,1,142
1,31436,31733,AluJo,1,297
1,31436,31733,AluJo,1,297
1,31720,31733,dust,0,13
1,31734,31754,MIRc,1,20
1,31734,31754,MIRc,1,20
1,32841,33037,MIR,1,196
1,32841,33037,MIR,1,196
1,33048,33456,L1MB5,1,408
1,33048,33456,L1MB5,1,408
1,33450,33464,dust,0,14
1,33466,33509,AluYc,1,43
1,33466,33509,AluYc,1,43
1,33521,33541,dust,0,20
1,33529,34041,L1PA6,-1,512
1,33529,34041,L1PA6,-1,512
1,34048,34108,L1P1,1,60
1,34048,34108,L1P1,1,60
1,34451,34560,L2c,-1,109
1,34451,34560,L2c,-1,109
1,34565,34921,MLT1J2,-1,356
1,34565,34921,MLT1J2,-1,356
1,35217,35366,MIRb,-1,149
1,35217,35366,MIRb,-1,149
1,35367,35499,AluJr,1,132
1,35367,35499,AluJr,1,132
1,35484,35509,dust,0,25
1,35484,35507,trf,0,23
1,36352,36364,dust,0,12
1,37045,37431,Charlie5,1,386
1,37045,37431,Charlie5,1,386
1,37241,37250,dust,0,9
1,37733,37861,L2c,1,128
1,37733,37861,L2c,1,128
1,38059,38191,L2a,1,132
1,38059,38191,L2a,1,132
1,38256,39464,MLT1E1A-int,1,1208
1,38256,39464,MLT1E1A-int,1,1208
1,39465,39623,MLT1E1A,1,158
1,39465,39623,MLT1E1A,1,158
1,39624,39924,AluSx,1,300
1,39624,39924,AluSx,1,300
1,39906,39925,dust,0,19
1,39925,40294,MLT1E1A,1,369
1,39925,40294,MLT1E1A,1,369
1,40333,40626,L2a,1,293
1,40333,40626,L2a,1,293
1,40614,40658,dust,0,44
1,40629,40729,AluSz6,-1,100
1,40629,40729,AluSz6,-1,100
1,40736,40878,LTR16C,-1,142
1,40736,40878,LTR16C,-1,142
1,41380,42285,ERVL-E-int,-1,905
1,41380,42285,ERVL-E-int,-1,905
1,42370,42504,MamRep1527,1,134
1,42370,42504,MamRep1527,1,134
1,42750,42785,dust,0,35
1,43243,45753,L1MA8,1,2510
1,43243,44835,L1MA8,1,1592
1,43591,43598,dust,0,7
1,43797,43812,dust,0,15
1,44174,44183,dust,0,9
1,44658,44671,dust,0,13
1,44829,44887,dust,0,58
1,44836,44876,trf,0,40
1,44836,44876,(TAAA)n,1,40
1,44877,45753,L1MA8,1,876
1,45719,45801,dust,0,82
1,45887,45987,L1M5,1,100
1,45887,45987,L1M5,1,100
1,46079,46198,L1MA9,1,119
1,46079,46198,L1MA9,1,119
1,46217,46240,AT_rich,1,23
1,46403,46416,dust,0,13
1,46416,46493,LTR12F,-1,77
1,46416,46493,LTR12F,-1,77
1,46553,46722,MER45A,1,169
1,46553,46722,MER45A,1,169
1,46893,47092,MER58A,-1,199
1,46893,47092,MER58A,-1,199
1,47319,47328,dust,0,9
1,47561,47573,dust,0,12
1,48417,49518,L1PA14,1,1101
1,48417,49518,L1PA14,1,1101
1,48745,48752,dust,0,7
1,49498,49534,dust,0,36
1,49826,49861,dust,0,35
1,49833,49858,trf,0,25
1,50129,50157,AT_rich,1,28
1,50482,50513,dust,0,31
1,50482,50513,trf,0,31
1,50482,50513,(TG)n,1,31
1,50563,50626,dust,0,63
1,50571,50626,T-rich,1,55
1,51585,51880,AluYj4,1,295
1,51585,51880,AluYj4,1,295
1,51865,51877,dust,0,12
1,52138,52243,trf,0,105
1,52140,52194,dust,0,54
1,52146,52166,AT_rich,1,20
1,52155,52222,trf,0,67
1,52209,52240,AT_rich,1,31
1,53745,53780,AT_rich,1,35
1,54465,54806,L2,1,341
1,54465,54712,L2,1,247
1,54711,54820,dust,0,109
1,54713,54817,trf,0,104
1,54713,54820,(TTTC)n,1,107
1,54807,54937,FLAM_A,-1,130
1,54822,54937,FLAM_A,-1,115
1,54939,55608,L2,1,669
1,54939,55608,L2,1,669
1,55338,55350,dust,0,12
1,56975,56995,dust,0,20
1,59056,59208,L2a,-1,152
1,59056,59208,L2a,-1,152
1,59897,59934,trf,0,37
1,60379,60686,MER47A,-1,307
1,60379,60686,MER47A,-1,307
1,61351,61361,dust,0,10
1,61604,61862,L1ME4c,-1,258
1,61604,61862,L1ME4c,-1,258
1,61863,62160,AluSc,-1,297
1,61863,61880,dust,0,17
1,61863,62160,AluSc,-1,297
1,62161,62229,L1ME4c,-1,68
1,62161,62229,L1ME4c,-1,68
1,62232,62256,dust,0,24
1,62232,62256,trf,0,24
1,62232,62256,(CA)n,1,24
1,62500,62559,dust,0,59
1,62597,62665,dust,0,68
1,63986,64012,trf,0,26
1,64426,64666,L1PA4,1,240
1,64426,64666,L1PA4,1,240
1,64508,64529,dust,0,21
1,64658,64666,dust,0,8
1,65977,66134,MIR3,-1,157
1,65977,66134,MIR3,-1,157
1,66158,66236,(TA)n,1,78
1,66160,66629,trf,0,469
1,66161,66630,dust,0,469
1,66161,66630,trf,0,469
1,66164,66632,trf,0,468
1,66237,66415,(TATAA)n,1,178
1,66379,66540,(TTATA)n,1,161
1,66541,66630,(TA)n,1,89
1,66795,66802,dust,0,7
1,67948,67960,dust,0,12
1,67999,68246,MIRb,-1,247
1,67999,68246,MIRb,-1,247
1,68507,68676,T-rich,1,169
1,68614,68658,trf,0,44
1,68619,68671,dust,0,52
1,70342,70367,AT_rich,1,25
1,70352,70395,dust,0,43
1,70504,70712,LTR89,-1,208
1,70504,70712,LTR89,-1,208
1,70723,70955,MIRb,1,232
1,70723,70955,MIRb,1,232
1,71176,71186,dust,0,10
1,71369,71645,L1M5,1,276
1,71369,71645,L1M5,1,276
1,71741,71829,L1M5,1,88
1,71741,71829,L1M5,1,88
1,71847,71861,dust,0,14
1,72090,72164,dust,0,74
1,72090,72164,trf,0,74
1,72090,72164,(TA)n,1,74
1,72121,72164,trf,0,43
1,72185,72525,L1PA7,-1,340
1,72185,72525,L1PA7,-1,340
1,72526,72897,L1PA7,1,371
1,72526,72897,L1PA7,1,371
1,73009,73678,L1PA16,-1,669
1,73009,73678,L1PA16,-1,669
1,73688,73843,L1M5,1,155
1,73688,73843,L1M5,1,155
1,73843,73856,dust,0,13
1,73845,74895,L1PA2,-1,1050
1,73845,74895,L1PA2,-1,1050
1,73985,74007,dust,0,22
1,74898,76697,L1PA2,1,1799
1,74898,76697,L1PA2,1,1799
1,76693,76892,L1MC5a,1,199
1,76693,76892,L1MC5a,1,199
1,76893,77201,AluSz,1,308
1,76893,77201,AluSz,1,308
1,77175,77195,dust,0,20
1,77175,77195,trf,0,20
1,77202,77638,L1MC5a,1,436
1,77202,77638,L1MC5a,1,436
1,77717,78235,L1MC5a,1,518
1,77717,78235,L1MC5a,1,518
1,78232,78283,L1M2,1,51
1,78232,78283,L1M2,1,51
1,78286,78421,AluJr,1,135
1,78286,78421,AluJr,1,135
1,78405,78445,dust,0,40
1,78422,78454,AT_rich,1,32
1,78459,78890,L1M2,1,431
1,78459,78890,L1M2,1,431
1,78891,79850,L1PREC2,1,959
1,78891,79850,L1PREC2,1,959
1,79830,80634,L1PB,1,804
1,79830,80634,L1PB,1,804
1,80620,80627,dust,0,7
1,80712,80804,Tigger5b,1,92
1,80712,80804,Tigger5b,1,92
1,80805,81096,AluSc5,1,291
1,80805,81096,AluSc5,1,291
1,81081,81088,dust,0,7
1,81097,81231,Tigger5b,1,134
1,81097,81231,Tigger5b,1,134
1,81232,81691,Tigger5,1,459
1,81232,81691,Tigger5,1,459
1,81694,82270,L1M5,1,576
1,81694,82270,L1M5,1,576
1,81826,81878,dust,0,52
1,81924,81970,dust,0,46
1,82134,82154,dust,0,20
1,82134,82154,trf,0,20
1,82285,83584,L1M4,1,1299
1,82285,83830,L1M4,1,1545
1,83506,83682,trf,0,176
1,83592,83802,L1M4,1,210
1,83787,84043,dust,0,256
1,83788,84041,trf,0,253
1,83831,84041,(GAAA)n,1,210
1,84042,85700,L1M4,1,1658
1,84076,85700,L1M4,1,1624
1,84098,84105,dust,0,7
1,85700,85986,L1M4,1,286
1,85700,85986,L1M4,1,286
1,85805,85812,dust,0,7
1,86030,86619,L1MC5a,1,589
1,86030,86619,L1MC5a,1,589
1,86818,87087,HAL1M8,1,269
1,86818,87087,HAL1M8,1,269
1,87091,87124,dust,0,33
1,87126,87413,AluJo,-1,287
1,87126,87413,AluJo,-1,287
1,87277,87292,dust,0,15
1,87423,87493,LTR103b_Mam,1,70
1,87423,87493,LTR103b_Mam,1,70
1,87530,87547,dust,0,17
1,87530,87555,AT_rich,1,25
1,88144,88823,L2,1,679
1,88144,88823,L2,1,679
1,88675,88962,trf,0,287
1,88925,89104,L2a,1,179
1,88925,89104,L2a,1,179
1,89107,89174,L2a,1,67
1,89107,89174,L2a,1,67
1,89286,89381,L1M5,-1,95
1,89286,89381,L1M5,-1,95
1,89859,90056,MLT1H2,1,197
1,89859,90056,MLT1H2,1,197
1,90048,90438,trf,0,390
1,90443,90576,MLT1H2,1,133
1,90443,90576,MLT1H2,1,133
1,90921,91213,AluY,1,292
1,90921,91213,AluY,1,292
1,91201,91213,dust,0,12
1,91552,91560,dust,0,8
1,91609,91677,MER4D1,-1,68
1,91609,91677,MER4D1,-1,68
1,91678,91826,MER4A,1,148
1,91678,91826,MER4A,1,148
1,91823,92110,MER4CL34,1,287
1,91823,92110,MER4CL34,1,287
1,92114,92392,MER4D1,-1,278
1,92114,92392,MER4D1,-1,278
1,92210,92243,trf,0,33
1,92553,92783,MIR,1,230
1,92553,92783,MIR,1,230
1,92664,92677,dust,0,13
1,92860,92903,MIR3,1,43
1,92860,92903,MIR3,1,43
1,93159,93421,L5,1,262
1,93159,93421,L5,1,262
1,93721,93753,dust,0,32
1,93729,94031,AluSc,-1,302
1,93729,94031,AluSc,-1,302
1,93731,93753,trf,0,22
1,94078,94355,L2,1,277
1,94078,94355,L2,1,277
1,94520,94816,MLT1H,-1,296
1,94520,94816,MLT1H,-1,296
1,94810,94847,dust,0,37
1,94810,94847,trf,0,37
1,94820,95080,AluY,-1,260
1,94820,95080,AluY,-1,260
1,94997,95019,dust,0,22
1,95000,95020,trf,0,20
1,95539,95569,(CAA)n,1,30
1,97003,97068,dust,0,65
1,97014,97068,(TG)n,1,54
1,97689,97696,dust,0,7
1,97802,98085,MLT1I,1,283
1,97802,98085,MLT1I,1,283
1,98999,99116,dust,0,117
1,99000,99042,(TTTA)n,1,42
1,99041,99088,T-rich,1,47
1,99047,99115,trf,0,68
1,99089,99397,AluSg4,-1,308
1,99089,99397,AluSg4,-1,308
1,99724,99796,L3,1,72
1,99724,99796,L3,1,72
1,99885,100292,MamRep605,-1,407
1,99885,100292,MamRep605,-1,407
1,100344,100421,MamRep605,-1,77
1,100344,100421,MamRep605,-1,77
1,101056,101352,AluSz,1,296
1,101056,101352,AluSz,1,296
1,101336,101348,dust,0,12
1,101404,101690,AluJr,1,286
1,101404,101690,AluJr,1,286
1,101513,101520,dust,0,7
1,101675,101690,dust,0,15
1,101719,101821,L1M5,1,102
1,101719,101821,L1M5,1,102
1,101822,102122,AluSx,1,300
1,101822,102122,AluSx,1,300
1,102110,102152,trf,0,42
1,102123,102194,L1M5,1,71
1,102123,102194,L1M5,1,71
1,102548,102780,MIRb,-1,232
1,102548,102780,MIRb,-1,232
1,102783,102975,L3,1,192
1,102783,102975,L3,1,192
1,102960,102968,dust,0,8
1,102976,103282,AluSx3,1,306
1,102976,103280,AluSx3,1,304
1,103255,103287,dust,0,32
1,103257,103280,trf,0,23
1,103281,103357,L3,1,76
1,103283,103357,L3,1,74
1,103375,103466,LTR33,-1,91
1,103375,103467,LTR33,-1,92
1,103468,103616,MSTB1,1,148
1,103468,103616,MSTB1,1,148
1,103617,103909,AluSq,-1,292
1,103617,103630,dust,0,13
1,103617,103909,AluSq,-1,292
1,103910,104165,MSTB1,1,255
1,103910,104160,MSTB1,1,250
1,104161,104196,dust,0,35
1,104161,104196,trf,0,35
1,104161,104199,(CA)n,1,38
1,104200,104215,MSTB1,1,15
1,104216,104254,LTR33,-1,38
1,104338,104506,LTR33,-1,168
1,104338,104506,LTR33,-1,168
1,104518,105076,L3,1,558
1,104518,105076,L3,1,558
1,105609,105627,dust,0,18
1,105629,105742,L1ME4a,1,113
1,105629,105742,L1ME4a,1,113
1,106430,106531,MER5B,-1,101
1,106430,106531,MER5B,-1,101
1,106929,106951,dust,0,22
1,107481,107773,MLT1C,1,292
1,107481,107773,MLT1C,1,292
1,107778,107869,MIR,-1,91
1,107778,107869,MIR,-1,91
1,107868,108329,L2b,1,461
1,107868,108329,L2b,1,461
1,108330,108564,AluJb,1,234
1,108330,108564,AluJb,1,234
1,108445,108469,trf,0,24
1,108546,108561,dust,0,15
1,108565,108680,L2b,1,115
1,108565,108680,L2b,1,115
1,109543,109620,MER4-int,1,77
1,109565,109614,dust,0,49
1,109565,109614,trf,0,49
1,109565,109614,(TG)n,1,49
1,109772,109813,dust,0,41
1,109775,109813,(CATATA)n,1,38
1,109836,110009,FAM,-1,173
1,109836,110009,FAM,-1,173
1,110086,110944,L1PA14,1,858
1,110086,110944,L1PA14,1,858
1,110190,110198,dust,0,8
1,110923,110956,dust,0,33
1,111003,111049,MIR,-1,46
1,111003,111049,MIR,-1,46
1,111081,111386,AluSq2,1,305
1,111081,111386,AluSq2,1,305
1,111367,111386,dust,0,19
1,111440,111490,trf,0,50
1,112084,112582,L2b,1,498
1,112084,112582,L2b,1,498
1,113692,114101,MLT1F2,1,409
1,113692,114101,MLT1F2,1,409
1,113872,113904,dust,0,32
1,114202,114677,L1ME3E,1,475
1,114202,114677,L1ME3E,1,475
1,114235,114259,dust,0,24
1,114469,114476,dust,0,7
1,114545,114572,dust,0,27
1,115058,115194,LTR33B,1,136
1,115058,115194,LTR33B,1,136
1,115343,115445,L2,-1,102
1,115343,115445,L2,-1,102
1,115577,115714,MER65D,1,137
1,115577,115714,MER65D,1,137
1,115789,116069,MER65D,1,280
1,115789,116069,MER65D,1,280
1,116092,116208,L1M5,-1,116
1,116092,116208,L1M5,-1,116
1,116373,117031,L2a,1,658
1,116373,117031,L2a,1,658
1,117032,117228,L1ME3E,1,196
1,117032,117228,L1ME3E,1,196
1,117222,117608,L1ME3E,1,386
1,117222,117608,L1ME3E,1,386
1,117611,118100,MLT1D,1,489
1,117611,118100,MLT1D,1,489
1,118101,119102,L1ME3E,1,1001
1,118101,119102,L1ME3E,1,1001
1,118812,118865,dust,0,53
1,119284,119343,dust,0,59
1,119434,119479,dust,0,45
1,119435,119479,AT_rich,1,44
1,119528,119579,dust,0,51
1,119564,119944,THE1C,-1,380
1,119564,119944,THE1C,-1,380
1,119871,119897,trf,0,26
1,120345,120352,dust,0,7
1,120508,120517,dust,0,9
1,120968,121135,dust,0,167
1,120968,121135,trf,0,167
1,120969,121135,trf,0,166
1,120969,121135,trf,0,166
1,120969,121135,trf,0,166
1,120976,121135,(TA)n,1,159
1,121270,121565,AluY,-1,295
1,121270,121284,dust,0,14
1,121270,121565,AluY,-1,295
1,121603,121725,dust,0,122
1,121638,121711,AT_rich,1,73
1,123039,123131,dust,0,92
1,123086,123131,(TA)n,1,45
1,123089,123131,trf,0,42
1,123171,123267,L1MA5,1,96
1,123171,123267,L1MA5,1,96
1,123398,123445,trf,0,47
1,123632,123702,L2a,1,70
1,123632,123702,L2a,1,70
1,123709,123821,L2a,1,112
1,123709,123821,L2a,1,112
1,123833,124404,L2c,1,571
1,123833,124404,L2c,1,571
1,124568,124870,AluJb,1,302
1,124568,124870,AluJb,1,302
1,124846,124870,dust,0,24
1,124846,124870,trf,0,24
1,125657,125665,dust,0,8
1,125925,125985,dust,0,60
1,126035,126235,L1MA5,1,200
1,126035,126235,L1MA5,1,200
1,126222,126239,dust,0,17
1,126237,126991,L1M4,1,754
1,126237,126991,L1M4,1,754
1,126453,126461,dust,0,8
1,126937,126993,dust,0,56
1,127133,127160,AT_rich,1,27
1,127136,127143,dust,0,7
1,127548,127657,L2a,-1,109
1,127548,127657,L2a,-1,109
1,127782,128051,AluSz,-1,269
1,127782,128051,AluSz,-1,269
1,128488,128595,L2a,-1,107
1,128488,128595,L2a,-1,107
1,128596,128893,AluSq2,-1,297
1,128596,128611,dust,0,15
1,128596,128893,AluSq2,-1,297
1,128894,129019,L2a,-1,125
1,128894,129019,L2a,-1,125
1,129149,129157,dust,0,8
1,129383,129675,AluSx,-1,292
1,129383,129409,dust,0,26
1,129383,129675,AluSx,-1,292
1,129529,129568,trf,0,39
1,129678,129788,FLAM_C,-1,110
1,129678,129692,dust,0,14
1,129678,129788,FLAM_C,-1,110
1,129789,129891,AluJo,1,102
1,129789,129891,AluJo,1,102
1,129907,129998,L1M2,1,91
1,129907,129998,L1M2,1,91
1,129968,129998,dust,0,30
1,129999,130313,AluSg,1,314
1,129999,130313,AluSg,1,314
1,130285,130300,dust,0,15
1,130314,130748,L1M2,1,434
1,130314,130748,L1M2,1,434
1,130756,130976,AluSq2,1,220
1,130756,130976,AluSq2,1,220
1,130956,130991,dust,0,35
1,130956,130992,trf,0,36
1,130965,130992,trf,0,27
1,130966,130992,trf,0,26
1,134066,134374,AluSg,-1,308
1,134066,134094,dust,0,28
1,134066,134094,trf,0,28
1,134066,134374,AluSg,-1,308
1,134838,134865,dust,0,27
1,136200,137288,trf,0,1088
1,136200,137288,trf,0,1088
1,136200,137288,trf,0,1088
1,137396,137465,trf,0,69
1,138259,138351,trf,0,92
1,138822,138938,trf,0,116
1,138822,138966,trf,0,144
1,139378,139457,trf,0,79
1,139708,140127,MER1A,-1,419
1,139708,140127,MER1A,-1,419
1,140413,140492,FLAM_A,1,79
1,140413,140492,FLAM_A,1,79
1,140495,140784,AluJo,1,289
1,140495,140784,AluJo,1,289
1,140566,140589,trf,0,23
1,140768,140784,dust,0,16
1,140785,141290,MER21C,1,505
1,140785,141290,MER21C,1,505
1,141291,141597,AluJb,-1,306
1,141291,141597,AluJb,-1,306
1,141295,141302,dust,0,7
1,141454,141481,dust,0,27
1,141598,141667,MER21C,1,69
1,141598,141667,MER21C,1,69
1,141668,141970,AluJr,1,302
1,141668,141970,AluJr,1,302
1,141971,142271,MER21C,1,300
1,141971,142271,MER21C,1,300
1,142308,142506,MIRb,1,198
1,142308,142506,MIRb,1,198
1,142766,142869,L2b,1,103
1,142766,142869,L2b,1,103
1,143165,143272,AluJb,-1,107
1,143165,143272,AluJb,-1,107
1,143306,143430,AluJr,1,124
1,143306,143430,AluJr,1,124
1,143444,143875,MER1A,-1,431
1,143444,143875,MER1A,-1,431
1,144178,144228,LTR41,-1,50
1,144178,144234,LTR41,-1,56
1,144235,144525,AluJb,1,290
1,144235,144525,AluJb,1,290
1,144528,144576,dust,0,48
1,144528,144576,trf,0,48
1,144528,144579,(TA)n,1,51
1,144579,144605,LTR41,-1,26
1,144580,144605,LTR41,-1,25
1,144606,144899,AluSp,1,293
1,144606,144899,AluSp,1,293
1,144888,144899,dust,0,11
1,144900,144986,LTR41,-1,86
1,144900,144986,LTR41,-1,86
1,144987,145294,AluJr,1,307
1,144987,145294,AluJr,1,307
1,145107,145114,dust,0,7
1,145274,145294,dust,0,20
1,145655,145884,L2b,1,229
1,145655,145884,L2b,1,229
1,145912,145999,L2b,1,87
1,145912,145999,L2b,1,87
1,146052,146227,MLT1D,1,175
1,146052,146227,MLT1D,1,175
1,146229,146522,AluJr,1,293
1,146229,146522,AluJr,1,293
1,146776,147047,AluJr,1,271
1,146776,147047,AluJr,1,271
1,147038,147047,dust,0,9
1,147060,147161,AluJb,-1,101
1,147062,147156,AluJr4,-1,94
1,147162,147463,AluSx,1,301
1,147162,147431,AluSx,1,269
1,147434,147481,dust,0,47
1,147434,147475,trf,0,41
1,147434,147475,(CAA)n,1,41
1,147435,147478,trf,0,43
1,147476,147535,AluJb,-1,59
1,147480,147535,AluJo,-1,55
1,147592,147601,dust,0,9
1,147595,147625,L1M4,1,30
1,147595,147625,L1MB8,1,30
1,147626,147917,AluJb,1,291
1,147626,147917,AluJb,1,291
1,147908,147917,dust,0,9
1,147918,148005,L1M4,1,87
1,147918,148005,L1MB8,1,87
1,148040,148150,AluJo,-1,110
1,148040,148150,FLAM_A,-1,110
1,148151,148770,L1MB8,1,619
1,148151,148770,L1MB8,1,619
1,148324,148343,trf,0,19
1,148792,149093,AluJr,1,301
1,148792,149093,AluJr,1,301
1,149097,149211,Tigger12,-1,114
1,149097,149211,Tigger12,-1,114
1,149396,149703,AluSq2,1,307
1,149396,149703,AluSq2,1,307
1,149680,149699,dust,0,19
1,149683,149703,trf,0,20
1,149865,150008,LTR37A,-1,143
1,149865,150008,LTR37A,-1,143
1,150154,150449,AluJo,-1,295
1,150154,150449,AluJo,-1,295
1,150317,150330,dust,0,13
1,150450,150476,AT_rich,1,26
1,150452,150490,dust,0,38
1,150478,150612,AluJr,-1,134
1,150478,150612,AluJr,-1,134
1,150712,151315,L2a,1,603
1,150712,151315,L2a,1,603
1,151317,151479,AluJb,-1,162
1,151317,151479,AluJb,-1,162
1,151480,151766,AluSg7,-1,286
1,151480,151497,dust,0,17
1,151480,151766,AluSg7,-1,286
1,151767,151894,AluJb,-1,127
1,151767,151894,AluJb,-1,127
1,151779,151786,dust,0,7
1,151915,152272,MLT1D,-1,357
1,151915,152272,MLT1D,-1,357
1,152276,152566,AluJr,1,290
1,152276,152566,AluJr,1,290
1,152567,152825,MER21C,1,258
1,152567,152825,MER21C,1,258
1,152826,153119,AluSq2,-1,293
1,152826,152835,dust,0,9
1,152826,153119,AluSq2,-1,293
1,153120,153429,MER21C,1,309
1,153120,153429,MER21C,1,309
1,153430,153735,AluJo,1,305
1,153430,153735,AluJo,1,305
1,153717,153735,dust,0,18
1,153736,154035,MER21C,1,299
1,153736,154035,MER21C,1,299
1,154037,155099,MER11B,1,1062
1,154037,155099,MER11B,1,1062
1,155145,155339,MIRb,1,194
1,155145,155339,MIRb,1,194
1,155554,155617,(CACCC)n,1,63
1,155561,155614,dust,0,53
1,155855,155869,dust,0,14
1,155994,156015,dust,0,21
1,155995,156114,AluJb,-1,119
1,155995,156114,AluJb,-1,119
1,156117,156417,AluJo,-1,300
1,156117,156417,AluJo,-1,300
1,156280,156298,dust,0,18
1,156457,156597,L1ME4b,1,140
1,156457,156597,L1ME4b,1,140
1,156719,156757,AT_rich,1,38
1,156828,157135,AluJr,1,307
1,156828,157135,AluJr,1,307
1,156946,156964,dust,0,18
1,157108,157121,dust,0,13
1,157183,157358,AluSz,1,175
1,157183,157358,AluSz,1,175
1,157359,157495,L1ME4c,1,136
1,157359,157495,L1ME4c,1,136
1,157496,157503,dust,0,7
1,157499,157618,AluJr4,-1,119
1,157499,157618,AluJr4,-1,119
1,157619,157742,L1ME4c,1,123
1,157619,157742,L1ME4c,1,123
1,157765,157781,dust,0,16
1,158107,158214,MER8,-1,107
1,158107,158214,MER8,-1,107
1,158226,158370,AluJb,1,144
1,158226,158370,AluJb,1,144
1,158713,158996,AluJr,1,283
1,158713,158996,AluJr,1,283
1,158998,159031,dust,0,33
1,158998,159031,trf,0,33
1,158998,159031,(CA)n,1,33
1,159356,159579,AluSx1,1,223
1,159356,159579,AluSx1,1,223
1,160472,160487,dust,0,15
1,161300,161705,L1MC5a,1,405
1,161300,161705,L1MC5a,1,405
1,161568,161576,dust,0,8
1,161716,161807,L1MC5a,1,91
1,161716,161807,L1MC5a,1,91
1,162116,162181,MSTD,-1,65
1,162116,162181,MSTD,-1,65
1,162170,162399,dust,0,229
1,162173,162325,trf,0,152
1,162182,162355,GA-rich,1,173
1,162197,162341,trf,0,144
1,162198,162344,trf,0,146
1,162356,162392,G-rich,1,36
1,162394,162711,MSTD,-1,317
1,162394,162711,MSTD,-1,317
1,163815,163829,dust,0,14
1,163848,164153,AluSq2,1,305
1,163848,164128,AluSq2,1,280
1,164129,164153,dust,0,24
1,164130,164153,trf,0,23
1,164130,164153,(CAAAA)n,1,23
1,164359,164695,AluSq2,1,336
1,164359,164695,AluSq2,1,336
1,164404,164470,trf,0,66
1,164674,164695,dust,0,21
1,164674,164695,trf,0,21
1,164799,164812,dust,0,13
1,165007,165310,AluSx1,1,303
1,165007,165310,AluSx1,1,303
1,165288,165310,dust,0,22
1,165288,165310,trf,0,22
1,166056,166334,AluSx1,1,278
1,166056,166334,AluSx1,1,278
1,166368,166501,MIRb,-1,133
1,166368,166501,MIRb,-1,133
1,166581,166613,dust,0,32
1,167134,167433,AluSp,-1,299
1,167134,167433,AluSp,-1,299
1,167495,167792,AluSg7,1,297
1,167495,167792,AluSg7,1,297
1,167774,167781,dust,0,7
1,168485,168786,AluYh3,1,301
1,168485,168786,AluYh3,1,301
1,168572,168606,dust,0,34
1,168767,168786,dust,0,19
1,168915,169342,MLT1D,1,427
1,168915,169342,MLT1D,1,427
1,169374,169679,AluSz,1,305
1,169374,169679,AluSz,1,305
1,169658,169679,dust,0,21
1,169857,170149,AluSz6,-1,292
1,169857,170149,AluSz6,-1,292
1,169860,169872,dust,0,12
1,170470,170477,dust,0,7
1,170894,170935,Charlie4z,1,41
1,170894,170934,Charlie4z,1,40
1,170935,170956,dust,0,21
1,170935,170954,trf,0,19
1,170935,171236,AluSq2,-1,301
1,170936,171236,AluSq2,-1,300
1,171237,171337,Charlie4z,1,100
1,171237,171337,Charlie4z,1,100
1,171383,171411,trf,0,28
1,172095,172112,dust,0,17
1,172096,172146,AluSq2,-1,50
1,172096,172146,AluSq2,-1,50
1,172407,172489,MIR1_Amn,-1,82
1,172407,172489,MIR1_Amn,-1,82
1,172833,172913,MIRb,-1,80
1,172833,172913,MIRb,-1,80
1,174382,174517,AluSx,1,135
1,174382,174686,trf,0,304
1,174382,174517,AluSx,1,135
1,174518,174820,AluSp,1,302
1,174518,174820,AluSp,1,302
1,174800,174820,dust,0,20
1,174821,174922,AluSx,1,101
1,174821,174922,AluSx,1,101
1,174903,174933,dust,0,30
1,174903,174933,trf,0,30
1,174925,174957,A-rich,1,32
1,175166,175478,AluSx,1,312
1,175166,175478,AluSx,1,312
1,175447,175479,dust,0,32
1,175447,175482,trf,0,35
1,175450,175478,trf,0,28
1,175597,175891,AluSp,-1,294
1,175597,175891,AluSp,-1,294
1,175599,175611,dust,0,12
1,175915,176231,AluSx1,1,316
1,175915,176248,AluSx,1,333
1,176201,176291,dust,0,90
1,176203,176231,trf,0,28
1,176379,176445,MIRb,-1,66
1,176379,176445,MIRb,-1,66
1,177301,177329,AT_rich,1,28
1,178196,178203,dust,0,7
1,178267,178275,dust,0,8
1,178291,178336,dust,0,45
1,178515,178573,dust,0,58
1,178522,178556,(TCTA)n,1,34
1,178685,178904,MER58A,1,219
1,178685,178904,MER58A,1,219
1,178987,179306,L2c,1,319
1,178987,179306,L2c,1,319
1,179625,179815,MIRb,1,190
1,179625,179815,MIRb,1,190
1,180088,180335,dust,0,247
1,180089,180998,trf,0,909
1,180089,180266,(CCCTAA)n,1,177
1,180289,180723,(CCCTAA)n,1,434
1,180371,180998,dust,0,627
1,180749,180998,(CCCTAA)n,1,249
1,180994,181980,TAR1,-1,986
1,180999,181980,TAR1,-1,981
1,181146,181329,dust,0,183
1,181147,181340,trf,0,193
1,181325,181434,trf,0,109
1,181523,181540,dust,0,17
1,181578,181600,dust,0,22
1,181687,181967,trf,0,280
1,181745,181981,trf,0,236
1,182024,182194,L1MC5a,-1,170
1,182024,182194,L1MC5a,-1,170
1,182197,182299,MER5B,-1,102
1,182197,182299,MER5B,-1,102
1,185786,185876,MIR3,-1,90
1,185786,185876,MIR3,-1,90
1,186313,186363,CT-rich,1,50
1,186885,186981,Charlie15a,-1,96
1,186885,186981,Charlie15a,-1,96
1,187235,187266,dust,0,31
1,187235,187271,(TGG)n,1,36
1,189430,189571,L2a,1,141
1,189430,189571,L2a,1,141
1,189829,189966,trf,0,137
1,190495,190928,L3,1,433
1,190495,190928,L3,1,433
1,191054,191252,Plat_L3,1,198
1,191054,191252,Plat_L3,1,198
1,192474,192599,MLT1K,1,125
1,192474,192599,MLT1K,1,125
1,193650,193865,MIR,-1,215
1,193650,193865,MIR,-1,215
1,194331,194563,L2a,1,232
1,194331,194563,L2a,1,232
1,194590,194726,MIR,1,136
1,194590,194726,MIR,1,136
1,194783,194973,L2a,1,190
1,194783,194973,L2a,1,190
1,196883,196934,MIR1_Amn,1,51
1,196883,196934,MIR1_Amn,1,51
1,197096,197166,L2c,-1,70
1,197096,197166,L2c,-1,70
1,197313,197576,AluSp,1,263
1,197313,197576,AluSp,1,263
1,197578,197644,L2c,-1,66
1,197578,197644,L2c,-1,66
1,197791,198040,MER33,1,249
1,197791,198040,MER33,1,249
1,198355,198532,MIRc,-1,177
1,198355,198532,MIRc,-1,177
1,198669,198820,MIR,-1,151
1,198669,198820,MIR,-1,151
1,198930,198937,dust,0,7
1,199108,199119,dust,0,11
1,199735,199798,dust,0,63
1,199863,199960,trf,0,97
1,200247,200302,dust,0,55
1,200409,200714,L1MB3,1,305
1,200409,200714,L1MB3,1,305
1,200731,200778,dust,0,47
1,200857,201046,MER53,-1,189
1,200857,201046,MER53,-1,189
1,201208,201362,MLT1A,1,154
1,201208,201362,MLT1A,1,154
1,201369,201479,dust,0,110
1,201369,201483,trf,0,114
1,201369,201472,(TC)n,1,103
1,201473,201651,MLT1A,1,178
1,201473,201651,MLT1A,1,178
1,201813,201955,MIRc,1,142
1,201813,201955,MIRc,1,142
1,201956,202252,AluJo,1,296
1,201956,202252,AluJo,1,296
1,202240,202252,dust,0,12
1,202253,202273,MIRc,1,20
1,202253,202273,MIRc,1,20
1,203361,203557,MIR,1,196
1,203361,203557,MIR,1,196
1,203568,203976,L1MB5,1,408
1,203568,203976,L1MB5,1,408
1,203970,203982,dust,0,12
1,203984,204027,AluYc,1,43
1,203984,204027,AluYc,1,43
1,204039,204057,dust,0,18
1,204045,204557,L1PA6,-1,512
1,204045,204557,L1PA6,-1,512
1,204564,204624,L1P1,1,60
1,204564,204624,L1P1,1,60
1,204720,204862,MLT1L,-1,142
1,204720,204862,MLT1L,-1,142
1,204967,205076,L2c,-1,109
1,204967,205076,L2c,-1,109
1,205081,205453,MLT1J2,-1,372
1,205081,205453,MLT1J2,-1,372
1,205733,205881,MIRb,-1,148
1,205733,205881,MIRb,-1,148
1,205883,206015,AluJr,1,132
1,205883,206015,AluJr,1,132
1,206000,206025,dust,0,25
1,206000,206023,trf,0,23
1,206868,206883,dust,0,15
1,207563,207666,Charlie5,1,103
1,207563,207666,Charlie5,1,103
1,207667,257666,dust,0,49999
1,257667,258054,trf,0,387
1,257678,257745,MLT2B3,-1,67
1,257678,257745,MLT2B3,-1,67
1,257771,257838,MLT2B3,-1,67
1,257771,257838,MLT2B3,-1,67
1,257864,257931,MLT2B3,-1,67
1,257864,257931,MLT2B3,-1,67
1,257957,258024,MLT2B3,-1,67
1,257957,258024,MLT2B3,-1,67
1,258028,258474,MER31-int,1,446
1,258028,258474,MER31-int,1,446
1,258504,258511,dust,0,7
1,259038,259589,MER92-int,1,551
1,259038,259589,MER92-int,1,551
1,259604,259773,MER92-int,1,169
1,259604,259773,MER92-int,1,169
1,259774,260073,AluY,1,299
1,259774,260074,AluY,1,300
1,260054,260074,trf,0,20
1,260074,260100,MER92-int,1,26
1,260075,260100,MER92-int,1,25
1,260105,260296,AluJb,1,191
1,260105,260296,AluJb,1,191
1,260289,260296,dust,0,7
1,260308,260409,MER92-int,1,101
1,260308,260409,MER92-int,1,101
1,260450,260534,MER34A,1,84
1,260450,260534,MER34A,1,84
1,260537,260945,L1MC3,1,408
1,260537,260945,L1MC3,1,408
1,260946,261385,MSTA1,1,439
1,260946,261385,MSTA1,1,439
1,261386,262746,L1MC3,1,1360
1,261386,262746,L1MC3,1,1360
1,261932,261976,dust,0,44
1,262684,262694,dust,0,10
1,263620,264060,MER4A1,1,440
1,263620,264060,MER4A1,1,440
1,264822,264940,(CCCTAA)n,1,118
1,265187,265582,MLT1I,1,395
1,265187,265582,MLT1I,1,395
1,265292,265300,dust,0,8
1,265586,265657,L2b,-1,71
1,265586,265657,L2b,-1,71
1,266095,266276,L1M5,-1,181
1,266095,266276,L1M5,-1,181
1,266352,266405,dust,0,53
1,266672,267153,MLT1H2,1,481
1,266672,267153,MLT1H2,1,481
1,266861,267015,trf,0,154
1,267498,267793,AluY,1,295
1,267498,267793,AluY,1,295
1,267778,267793,dust,0,15
1,268184,268253,MER4D1,-1,69
1,268184,268253,MER4D1,-1,69
1,268254,268402,MER4A,1,148
1,268254,268402,MER4A,1,148
1,268399,268672,MER4CL34,1,273
1,268399,268672,MER4CL34,1,273
1,268690,268968,MER4D1,-1,278
1,268690,268968,MER4D1,-1,278
1,268786,268819,trf,0,33
1,269129,269360,MIR,1,231
1,269129,269360,MIR,1,231
1,269240,269254,dust,0,14
1,269736,269998,L5,1,262
1,269736,269998,L5,1,262
1,270306,270608,AluSc,-1,302
1,270306,270330,dust,0,24
1,270306,270608,AluSc,-1,302
1,270308,270330,trf,0,22
1,270655,270932,L2,1,277
1,270655,270932,L2,1,277
1,271102,271393,MLT1H,-1,291
1,271102,271393,MLT1H,-1,291
1,271386,271429,dust,0,43
1,271387,271429,trf,0,42
1,271392,271429,trf,0,37
1,271402,271664,AluY,-1,262
1,271402,271664,AluY,-1,262
1,271579,271603,dust,0,24
1,272123,272153,(CAA)n,1,30
1,272196,272277,L1ME4a,-1,81
1,272196,272277,L1ME4a,-1,81
1,273585,273652,dust,0,67
1,273598,273652,(TG)n,1,54
1,274273,274280,dust,0,7
1,274386,274515,MLT1I,1,129
1,274386,274515,MLT1I,1,129
1,274608,274669,MLT1I,1,61
1,274608,274669,MLT1I,1,61
1,275583,275679,dust,0,96
1,275584,275614,(TTTA)n,1,30
1,275604,275679,trf,0,75
1,275612,275675,trf,0,63
1,275615,275649,T-rich,1,34
1,275650,275960,AluSg4,-1,310
1,275650,275960,AluSg4,-1,310
1,276287,276359,L3,1,72
1,276287,276359,L3,1,72
1,276448,276855,MamRep605,-1,407
1,276448,276855,MamRep605,-1,407
1,276907,276984,MamRep605,-1,77
1,276907,276984,MamRep605,-1,77
1,277622,277918,AluSz,1,296
1,277622,277918,AluSz,1,296
1,277902,277914,dust,0,12
1,277970,278255,AluJr,1,285
1,277970,278255,AluJr,1,285
1,278241,278255,dust,0,14
1,278284,278386,L1M5,1,102
1,278284,278386,L1M5,1,102
1,278387,278687,AluSx,1,300
1,278387,278687,AluSx,1,300
1,278675,278717,trf,0,42
1,278688,278759,L1M5,1,71
1,278688,278759,L1M5,1,71
1,279113,279345,MIRb,-1,232
1,279113,279345,MIRb,-1,232
1,279348,279541,L3,1,193
1,279348,279541,L3,1,193
1,279525,279534,dust,0,9
1,279542,279848,AluSx3,1,306
1,279542,279846,AluSx3,1,304
1,279821,279853,dust,0,32
1,279823,279846,trf,0,23
1,279847,279923,L3,1,76
1,279849,279923,L3,1,74
1,279941,280032,LTR33,-1,91
1,279941,280033,LTR33,-1,92
1,280034,280182,MSTB1,1,148
1,280034,280182,MSTB1,1,148
1,280183,280475,AluSq,-1,292
1,280183,280196,dust,0,13
1,280183,280475,AluSq,-1,292
1,280476,280731,MSTB1,1,255
1,280476,280726,MSTB1,1,250
1,280727,280760,dust,0,33
1,280727,280760,trf,0,33
1,280727,280763,(CA)n,1,36
1,280764,280779,MSTB1,1,15
1,280780,280818,LTR33,-1,38
1,280902,281070,LTR33,-1,168
1,280902,281070,LTR33,-1,168
1,281082,281640,L3,1,558
1,281082,281640,L3,1,558
1,282173,282191,dust,0,18
1,282193,282306,L1ME4a,1,113
1,282193,282306,L1ME4a,1,113
1,282994,283095,MER5B,-1,101
1,282994,283095,MER5B,-1,101
1,283493,283515,dust,0,22
1,284045,284337,MLT1C,1,292
1,284045,284337,MLT1C,1,292
1,284347,284433,MIRb,-1,86
1,284347,284433,MIRb,-1,86
1,284432,284893,L2a,1,461
1,284432,284893,L2a,1,461
1,284894,285131,AluJb,1,237
1,284894,285131,AluJb,1,237
1,285009,285033,trf,0,24
1,285110,285131,dust,0,21
1,285110,285131,trf,0,21
1,285132,285250,L2a,1,118
1,285132,285250,L2a,1,118
1,285880,285907,AT_rich,1,27
1,286113,286177,MER4-int,1,64
1,286135,286178,dust,0,43
1,286135,286178,trf,0,43
1,286135,286178,trf,0,43
1,286135,286178,(TG)n,1,43
1,286336,286377,dust,0,41
1,286339,286377,(CATATA)n,1,38
1,286400,286573,FAM,-1,173
1,286400,286573,FAM,-1,173
1,286650,287508,L1PA14,1,858
1,286650,287508,L1PA14,1,858
1,286754,286762,dust,0,8
1,287487,287520,dust,0,33
1,287567,287613,MIR,-1,46
1,287567,287613,MIR,-1,46
1,287645,287950,AluSq2,1,305
1,287645,287950,AluSq2,1,305
1,287931,287950,dust,0,19
1,288004,288054,trf,0,50
1,288450,288519,L2a,1,69
1,288450,288519,L2a,1,69
1,288611,289148,L2b,1,537
1,288611,289148,L2b,1,537
1,290258,290667,MLT1F2,1,409
1,290258,290667,MLT1F2,1,409
1,290426,290470,dust,0,44
1,290755,291083,L1ME3E,1,328
1,290755,291083,L1ME3E,1,328
1,290801,290825,dust,0,24
1,291035,291042,dust,0,7
1,291111,291136,dust,0,25
1,291622,291758,LTR33B,1,136
1,291622,291758,LTR33B,1,136
1,291907,292009,L2,-1,102
1,291907,292009,L2,-1,102
1,292141,292278,MER65D,1,137
1,292141,292278,MER65D,1,137
1,292355,292635,MER65D,1,280
1,292355,292635,MER65D,1,280
1,292658,292774,L1M5,-1,116
1,292658,292774,L1M5,-1,116
1,292939,293597,L2a,1,658
1,292939,293597,L2a,1,658
1,293598,293794,L1ME3E,1,196
1,293598,293794,L1ME3E,1,196
1,293788,294174,L1ME3E,1,386
1,293788,294174,L1ME3E,1,386
1,294177,294666,MLT1D,1,489
1,294177,294666,MLT1D,1,489
1,294667,295706,L1ME3E,1,1039
1,294667,295706,L1ME3E,1,1039
1,295382,295434,dust,0,52
1,295838,295898,dust,0,60
1,296004,296049,dust,0,45
1,296005,296049,AT_rich,1,44
1,296097,296149,dust,0,52
1,296134,296514,THE1C,-1,380
1,296134,296514,THE1C,-1,380
1,296915,296922,dust,0,7
1,297078,297087,dust,0,9
1,297538,297674,trf,0,136
1,297539,297674,dust,0,135
1,297539,297674,trf,0,135
1,297539,297674,(TA)n,1,135
1,297809,297956,AluYc,-1,147
1,297809,297823,dust,0,14
1,297809,297956,AluYc,-1,147
1,297969,347968,dust,0,49999
1,348443,348942,MER92-int,1,499
1,348443,348942,MER92-int,1,499
1,349009,349178,MER31-int,1,169
1,349009,349178,MER31-int,1,169
1,349179,349478,AluY,1,299
1,349179,349479,AluY,1,300
1,349459,349479,trf,0,20
1,349479,349505,MER31-int,1,26
1,349480,349505,MER31-int,1,25
1,349510,349701,AluJb,1,191
1,349510,349701,AluJb,1,191
1,349694,349701,dust,0,7
1,349705,349814,MER31-int,1,109
1,349705,349814,MER31-int,1,109
1,349855,349939,MER34A,1,84
1,349855,349939,MER34A,1,84
1,349942,350350,L1MC3,1,408
1,349942,350350,L1MC3,1,408
1,350351,350790,MSTA1,1,439
1,350351,350790,MSTA1,1,439
1,350791,352148,L1MC3,1,1357
1,350791,352148,L1MC3,1,1357
1,351337,351381,dust,0,44
1,352086,352096,dust,0,10
1,352110,352160,dust,0,50
1,353014,353455,MER4A1,1,441
1,353014,353455,MER4A1,1,441
1,354149,354322,(CCCTAA)n,1,173
1,354569,354964,MLT1I,1,395
1,354569,354964,MLT1I,1,395
1,354674,354682,dust,0,8
1,355477,355579,L1M5,-1,102
1,355477,355579,L1M5,-1,102
1,355611,355994,L1MD,-1,383
1,355611,355994,L1MD,-1,383
1,356054,356223,MLT1H2,1,169
1,356054,356223,MLT1H2,1,169
1,356243,356397,trf,0,154
1,356402,356535,MLT1H2,1,133
1,356402,356535,MLT1H2,1,133
1,356880,357175,AluY,1,295
1,356880,357175,AluY,1,295
1,357160,357175,dust,0,15
1,357566,357635,MER4D1,-1,69
1,357566,357635,MER4D1,-1,69
1,357636,357784,MER4A,1,148
1,357636,357784,MER4A,1,148
1,357781,358067,MER4CL34,1,286
1,357781,358067,MER4CL34,1,286
1,358068,358859,MER4D1,-1,791
1,358068,358859,MER4D1,-1,791
1,358946,359031,MIRb,1,85
1,358946,359031,MIRb,1,85
1,359293,359355,dust,0,62
1,359295,359355,C-rich,1,60
1,359691,359844,Charlie30a,-1,153
1,359691,359844,Charlie30a,-1,153
1,359697,359711,dust,0,14
1,360031,360064,dust,0,33
1,360031,360091,(CA)n,1,60
1,360089,360138,trf,0,49
1,360231,360495,MER31B,1,264
1,360231,360495,MER31B,1,264
1,360496,360784,AluJr,-1,288
1,360496,360513,dust,0,17
1,360496,360784,AluJr,-1,288
1,360789,360816,trf,0,27
1,360800,361618,L1MA4,1,818
1,360800,361618,L1MA4,1,818
1,361604,362236,trf,0,632
1,361619,361922,AluSx3,1,303
1,361619,361922,AluSx3,1,303
1,361899,361922,dust,0,23
1,361926,362238,AluSc,1,312
1,361926,362238,AluSc,1,312
1,362214,362238,dust,0,24
1,362239,362920,L1MA4,1,681
1,362239,362920,L1MA4,1,681
1,362986,363108,AluJb,1,122
1,362986,363108,AluJb,1,122
1,363090,363143,dust,0,53
1,364053,364106,trf,0,53
1,364336,364425,Charlie9,-1,89
1,364336,364425,Charlie9,-1,89
1,364859,365032,MIR3,-1,173
1,364859,365032,MIR3,-1,173
1,365405,365585,L1M5,-1,180
1,365405,365585,L1M5,-1,180
1,365676,366144,Ricksha_0,1,468
1,365676,366144,Ricksha_0,1,468
1,365733,365772,trf,0,39
1,366256,366350,MIRb,1,94
1,366256,366350,MIRb,1,94
1,366444,366553,trf,0,109
1,366599,366662,Tigger4b,1,63
1,366599,366662,Tigger4b,1,63
1,366947,367109,Charlie20a,1,162
1,366947,367109,Charlie20a,1,162
1,367113,367269,(CATATA)n,1,156
1,367184,367305,trf,0,121
1,367216,367394,(CA)n,1,178
1,367227,367289,dust,0,62
1,367245,367460,trf,0,215
1,367245,367460,trf,0,215
1,367349,367782,trf,0,433
1,367350,367483,(CATATA)n,1,133
1,367398,367561,trf,0,163
1,367428,367482,dust,0,54
1,367430,367930,(CA)n,1,500
1,367524,367752,trf,0,228
1,367611,367672,dust,0,61
1,367611,367662,trf,0,51
1,367611,367671,trf,0,60
1,367627,367850,trf,0,223
1,367654,367756,trf,0,102
1,367697,367963,trf,0,266
1,367697,367966,trf,0,269
1,367830,367965,(CATATA)n,1,135
1,367867,367930,dust,0,63
1,367999,368089,dust,0,90
1,367999,368050,trf,0,51
1,368000,368099,trf,0,99
1,368000,368165,(CA)n,1,165
1,368212,368313,Charlie20a,1,101
1,368212,368313,Charlie20a,1,101
1,368314,368609,AluSx1,-1,295
1,368314,368609,AluSx1,-1,295
1,368323,368330,dust,0,7
1,368621,368650,AT_rich,1,29
1,368638,368651,dust,0,13
1,368651,368780,L1MD3,-1,129
1,368651,368780,L1MD3,-1,129
1,368748,370063,trf,0,1315
1,370064,370626,L1MD3,-1,562
1,370064,370626,L1MD3,-1,562
1,370613,370656,dust,0,43
1,370613,370656,trf,0,43
1,370613,370656,trf,0,43
1,370614,370655,trf,0,41
1,370627,370933,AluSq,-1,306
1,370627,370933,AluSq,-1,306
1,370934,371004,L1MD3,-1,70
1,370934,371004,L1MD3,-1,70
1,371006,371038,dust,0,32
1,371009,371186,AluYf1,-1,177
1,371009,371037,trf,0,28
1,371009,371186,AluYf1,-1,177
1,371198,371751,L1MD3,-1,553
1,371198,371274,L1MD3,-1,76
1,371275,371314,dust,0,39
1,371275,371314,trf,0,39
1,371275,371314,(TG)n,1,39
1,371315,371751,L1MD3,-1,436
1,371669,372395,trf,0,726
1,371827,371903,L1MC4a,-1,76
1,371827,371903,L1MC4a,-1,76
1,371985,372067,L1MC4a,-1,82
1,371985,372067,L1MC4a,-1,82
1,372064,372146,L1MC4a,-1,82
1,372064,372146,L1MC4a,-1,82
1,372283,372922,trf,0,639
1,372362,372499,trf,0,137
1,372384,372411,dust,0,27
1,372414,372761,trf,0,347
1,372438,372463,dust,0,25
1,372442,372566,L1MC4a,-1,124
1,372442,372566,L1MC4a,-1,124
1,372545,372922,trf,0,377
1,372568,372594,dust,0,26
1,372573,372697,L1MC4a,-1,124
1,372573,372697,L1MC4a,-1,124
1,372676,372813,trf,0,137
1,372699,372777,dust,0,78
1,372756,372880,L1MC4a,-1,124
1,372756,372880,L1MC4a,-1,124
1,372882,372908,dust,0,26
1,372920,373494,L1MC4a,-1,574
1,372920,373494,L1MC4a,-1,574
1,373555,373562,dust,0,7
1,373843,373935,trf,0,92
1,373910,374159,C-rich,1,249
1,373937,374185,dust,0,248
1,373937,374159,trf,0,222
1,373974,374164,trf,0,190
1,373974,374164,trf,0,190
1,374632,375244,MER39B,-1,612
1,374632,375244,MER39B,-1,612
1,375560,375623,dust,0,63
1,375923,376219,AluY,1,296
1,375923,376219,AluY,1,296
1,376202,376219,dust,0,17
1,376484,377225,L1ME1,1,741
1,376484,377225,L1ME1,1,741
1,377415,377536,L1ME1,1,121
1,377415,377536,L1ME1,1,121
1,377587,377597,dust,0,10
1,378324,378450,trf,0,126
1,378324,378458,trf,0,134
1,378346,378451,trf,0,105
1,378493,378518,trf,0,25
1,379080,379127,dust,0,47
1,379080,379128,GA-rich,1,48
1,379452,379733,(TCTA)n,1,281
1,379577,379640,dust,0,63
1,381155,381699,trf,0,544
1,382218,382327,dust,0,109
1,382219,382393,(TG)n,1,174
1,382245,382632,trf,0,387
1,382521,382581,dust,0,60
1,382585,382648,dust,0,63
1,382721,382986,AluJr4,1,265
1,382721,382986,AluJr4,1,265
1,382977,383031,dust,0,54
1,382987,383050,AT_rich,1,63
1,383231,383530,AluSq2,1,299
1,383231,383530,AluSq2,1,299
1,383514,383530,dust,0,16
1,384836,385135,AluSx1,1,299
1,384836,385135,AluSx1,1,299
1,386049,386137,MLT1K,1,88
1,386049,386137,MLT1K,1,88
1,386143,386800,LTR9B,1,657
1,386143,386800,LTR9B,1,657
1,386902,387072,MLT1K,1,170
1,386902,387072,MLT1K,1,170
1,387218,387399,MER5A,-1,181
1,387218,387399,MER5A,-1,181
1,387652,387842,MIRb,-1,190
1,387652,387842,MIRb,-1,190
1,388085,388433,MER4E1,1,348
1,388085,388433,MER4E1,1,348
1,388102,388112,dust,0,10
1,388434,388732,AluSg4,-1,298
1,388434,388732,AluSg4,-1,298
1,388438,388446,dust,0,8
1,388733,389154,MER4E1,1,421
1,388733,389154,MER4E1,1,421
1,389326,389564,L2c,-1,238
1,389326,389564,L2c,-1,238
1,389994,390204,L1M5,-1,210
1,389994,390204,L1M5,-1,210
1,390335,390538,MIRc,-1,203
1,390335,390538,MIRc,-1,203
1,390636,390706,Charlie4z,-1,70
1,390636,390706,Charlie4z,-1,70
1,390708,391164,MLT1E3,1,456
1,390708,391164,MLT1E3,1,456
1,391313,391477,AluJo,1,164
1,391313,391477,AluJo,1,164
1,391464,391477,dust,0,13
1,392722,392812,MIRb,1,90
1,392722,392812,MIRb,1,90
1,393038,393205,MER5B,-1,167
1,393038,393205,MER5B,-1,167
1,393782,393807,dust,0,25
1,393782,393807,trf,0,25
1,393782,393807,(TG)n,1,25
1,394383,394537,L2a,1,154
1,394383,394537,L2a,1,154
1,394542,394646,trf,0,104
1,394542,394616,G-rich,1,74
1,394543,394646,dust,0,103
1,394618,394812,MIRb,1,194
1,394618,394812,MIRb,1,194
1,395273,395717,LTR37B,-1,444
1,395273,395717,LTR37B,-1,444
1,395719,396012,AluSq,-1,293
1,395719,395728,dust,0,9
1,395719,396012,AluSq,-1,293
1,396115,396269,MLT1O,-1,154
1,396115,396269,MLT1O,-1,154
1,396629,396685,AluSz6,-1,56
1,396629,396646,dust,0,17
1,396629,396685,AluSz6,-1,56
1,396699,396748,MSTA,1,49
1,396699,396748,MSTA,1,49
1,396745,396776,trf,0,31
1,396749,397059,AluSg,-1,310
1,396749,396776,dust,0,27
1,396749,396901,AluSx,-1,152
1,396902,396941,dust,0,39
1,396902,396941,trf,0,39
1,396902,396941,(TG)n,1,39
1,396942,397059,AluSx,-1,117
1,397060,397123,MSTA,1,63
1,397060,397123,MSTA,1,63
1,397124,397271,MIRb,1,147
1,397124,397271,MIRb,1,147
1,397525,397647,L2c,1,122
1,397525,397647,L2c,1,122
1,398052,398091,trf,0,39
1,398306,398476,MIRb,-1,170
1,398306,398476,MIRb,-1,170
1,399228,399346,MER103C,-1,118
1,399228,399346,MER103C,-1,118
1,399404,399464,MER103C,-1,60
1,399404,399464,MER103C,-1,60
1,399638,399782,MIRb,-1,144
1,399638,399782,MIRb,-1,144
1,399791,400104,LTR39,-1,313
1,399791,400104,LTR39,-1,313
1,400105,400403,AluSz6,1,298
1,400105,400403,AluSz6,1,298
1,400404,400705,LTR39,-1,301
1,400404,400705,LTR39,-1,301
1,400701,400715,dust,0,14
1,400706,400825,L1PA4,-1,119
1,400706,400825,L1PA4,-1,119
1,400826,400969,LTR39,-1,143
1,400826,400969,LTR39,-1,143
1,401461,401662,L2a,-1,201
1,401461,401662,L2a,-1,201
1,401719,401726,dust,0,7
1,401982,402263,AluSg,1,281
1,401982,402263,AluSg,1,281
1,402263,402288,dust,0,25
1,402264,402288,trf,0,24
1,402264,402288,(TAAA)n,1,24
1,402481,402608,LTR33,1,127
1,402481,402608,LTR33,1,127
1,402902,403133,MIR,1,231
1,402902,403133,MIR,1,231
1,403014,403030,dust,0,16
1,403509,403771,L5,1,262
1,403509,403771,L5,1,262
1,403884,404080,L2,1,196
1,403884,404080,L2,1,196
1,404081,404370,AluSc,-1,289
1,404081,404092,dust,0,11
1,404081,404370,AluSc,-1,289
1,404371,404722,L2,1,351
1,404371,404722,L2,1,351
1,404864,405149,MLT1H,-1,285
1,404864,405149,MLT1H,-1,285
1,405087,405094,dust,0,7
1,405150,405469,AluY,-1,319
1,405150,405178,dust,0,28
1,405150,405178,trf,0,28
1,405150,405469,AluY,-1,319
1,405328,405351,dust,0,23
1,405470,405515,MLT1H,-1,45
1,405470,405515,MLT1H,-1,45
1,405980,406010,(CAA)n,1,30
1,406053,406134,L1ME4a,-1,81
1,406053,406134,L1ME4a,-1,81
1,407439,407507,dust,0,68
1,407453,407507,(TG)n,1,54
1,407977,407984,dust,0,7
1,408239,408396,MLT1I,1,157
1,408239,408396,MLT1I,1,157
1,408460,408522,MLT1I,1,62
1,408460,408522,MLT1I,1,62
1,409435,409515,dust,0,80
1,409437,409471,trf,0,34
1,409437,409471,(TTTA)n,1,34
1,409471,409515,trf,0,44
1,409487,409796,AluSg4,-1,309
1,409487,409796,AluSg4,-1,309
1,410123,410195,L3,1,72
1,410123,410195,L3,1,72
1,410284,410691,MamRep605,-1,407
1,410284,410691,MamRep605,-1,407
1,410743,410821,MamRep605,-1,78
1,410743,410821,MamRep605,-1,78
1,411459,411758,AluSz,1,299
1,411459,411758,AluSz,1,299
1,411739,411754,dust,0,15
1,411816,412098,AluJr,1,282
1,411816,412098,AluJr,1,282
1,411919,411927,dust,0,8
1,412082,412098,dust,0,16
1,412127,412229,L1M5,1,102
1,412127,412229,L1M5,1,102
1,412230,412530,AluSx,1,300
1,412230,412530,AluSx,1,300
1,412518,412560,trf,0,42
1,412531,412602,L1M5,1,71
1,412531,412602,L1M5,1,71
1,412956,413017,MIRb,-1,61
1,412956,413017,MIRb,-1,61
1,413052,413109,trf,0,57
1,413063,413136,trf,0,73
1,413073,413109,trf,0,36
1,413113,413249,MIRb,-1,136
1,413113,413249,MIRb,-1,136
1,413252,413445,L3,1,193
1,413252,413445,L3,1,193
1,413429,413439,dust,0,10
1,413446,413752,AluSx3,1,306
1,413446,413757,AluSx,1,311
1,413725,413757,dust,0,32
1,413727,413750,trf,0,23
1,413753,413827,L3,1,74
1,413758,413827,L3,1,69
1,413845,413936,LTR33,-1,91
1,413845,413937,LTR33,-1,92
1,413938,414086,MSTB1,1,148
1,413938,414086,MSTB1,1,148
1,414087,414378,AluSq,-1,291
1,414087,414099,dust,0,12
1,414087,414378,AluSq,-1,291
1,414379,414634,MSTB1,1,255
1,414379,414629,MSTB1,1,250
1,414630,414675,dust,0,45
1,414630,414675,trf,0,45
1,414630,414678,(CA)n,1,48
1,414679,414694,MSTB1,1,15
1,414695,414733,LTR33,-1,38
1,414817,414985,LTR33,-1,168
1,414817,414985,LTR33,-1,168
1,414997,415262,L3,1,265
1,414997,415262,L3,1,265
1,415315,415772,Tigger5,1,457
1,415315,415772,Tigger5,1,457
1,415775,416346,L1M5,1,571
1,415775,416346,L1M5,1,571
1,415920,415976,dust,0,56
1,416213,416230,dust,0,17
1,416361,417885,L1M4,1,1524
1,416361,417872,L1M4,1,1511
1,416701,416723,dust,0,22
1,417589,417763,trf,0,174
1,417870,418053,dust,0,183
1,417873,418051,trf,0,178
1,417873,418051,(GAAA)n,1,178
1,418047,419710,L1M4,1,1663
1,418052,419710,L1M4,1,1658
1,418108,418116,dust,0,8
1,419710,419997,L1M4,1,287
1,419710,419997,L1M4,1,287
1,419729,419736,dust,0,7
1,419816,419823,dust,0,7
1,420040,420612,L1MC5a,1,572
1,420040,420612,L1MC5a,1,572
1,420649,420686,AT_rich,1,37
1,420830,421093,HAL1M8,1,263
1,420830,421093,HAL1M8,1,263
1,421216,421392,L1ME3B,1,176
1,421216,421392,L1ME3B,1,176
1,421326,421372,dust,0,46
1,421962,421994,AT_rich,1,32
1,421995,422041,L1PA6,-1,46
1,421995,422041,L1PA6,-1,46
1,422042,422069,AT_rich,1,27
1,422449,422456,dust,0,7
1,422983,423332,L2c,-1,349
1,422983,423332,L2c,-1,349
1,423393,423424,AT_rich,1,31
1,423473,423504,dust,0,31
1,423485,423760,L1PA5,-1,275
1,423485,423760,L1PA5,-1,275
1,423766,423986,L2c,-1,220
1,423766,423986,L2c,-1,220
1,424153,424229,L1ME3D,-1,76
1,424153,424229,L1ME3D,-1,76
1,424236,424397,AluJr,1,161
1,424236,424397,AluJr,1,161
1,424385,424397,dust,0,12
1,424424,425008,L1ME3D,-1,584
1,424424,425008,L1ME3D,-1,584
1,424941,424948,dust,0,7
1,425022,425069,dust,0,47
1,425044,425066,(TTTTG)n,1,22
1,425057,426080,L1P4,-1,1023
1,425067,426080,L1P4,-1,1013
1,425126,425134,dust,0,8
1,426131,426871,L1ME3D,-1,740
1,426131,426871,L1ME3D,-1,740
1,426636,426686,trf,0,50
1,426720,426728,dust,0,8
1,426754,426762,dust,0,8
1,426906,427029,L1MA8,-1,123
1,426906,427029,L1MA8,-1,123
1,427030,427765,L1MA2,1,735
1,427030,427765,L1MA2,1,735
1,427766,429747,L1MA8,-1,1981
1,427766,429747,L1MA8,-1,1981
1,428038,428051,dust,0,13
1,429746,429886,L1ME3D,-1,140
1,429746,429886,L1ME3D,-1,140
1,429902,430382,LTR22C2,1,480
1,429902,430382,LTR22C2,1,480
1,430418,431458,L1PA15-16,1,1040
1,430418,431458,L1PA15-16,1,1040
1,430863,430878,dust,0,15
1,431452,431864,L1P4,1,412
1,431452,431864,L1P4,1,412
1,431476,431487,dust,0,11
1,431867,432156,AluSq2,1,289
1,431867,432156,AluSq2,1,289
1,431987,431999,dust,0,12
1,432156,432331,dust,0,175
1,432156,432300,trf,0,144
1,432157,432271,(TA)n,1,114
1,432272,432758,L1PA8A,1,486
1,432272,432758,L1PA8A,1,486
1,432583,434972,trf,0,2389
1,432738,432835,L1PA8,1,97
1,432738,432835,L1PA8,1,97
1,432815,432912,L1PA8,1,97
1,432815,432912,L1PA8,1,97
1,432892,432989,L1PA8,1,97
1,432892,432989,L1PA8,1,97
1,432969,433066,L1PA8,1,97
1,432969,433066,L1PA8,1,97
1,433046,433143,L1PA8,1,97
1,433046,433143,L1PA8,1,97
1,433123,433220,L1PA8,1,97
1,433123,433220,L1PA8,1,97
1,433200,433297,L1PA8,1,97
1,433200,433297,L1PA8,1,97
1,433277,433374,L1PA8,1,97
1,433277,433374,L1PA8,1,97
1,433354,433451,L1PA8,1,97
1,433354,433451,L1PA8,1,97
1,433431,433528,L1PA8,1,97
1,433431,433528,L1PA8,1,97
1,433508,433605,L1PA8,1,97
1,433508,433605,L1PA8,1,97
1,433585,433682,L1PA8,1,97
1,433585,433682,L1PA8,1,97
1,433662,433759,L1PA8,1,97
1,433662,433759,L1PA8,1,97
1,433739,433836,L1PA8,1,97
1,433739,433836,L1PA8,1,97
1,433816,433913,L1PA8,1,97
1,433816,433913,L1PA8,1,97
1,433893,433990,L1PA8,1,97
1,433893,433990,L1PA8,1,97
1,433970,434067,L1PA8,1,97
1,433970,434067,L1PA8,1,97
1,434047,434144,L1PA8,1,97
1,434047,434144,L1PA8,1,97
1,434124,434221,L1PA8,1,97
1,434124,434221,L1PA8,1,97
1,434201,434298,L1PA8,1,97
1,434201,434298,L1PA8,1,97
1,434278,434375,L1PA8,1,97
1,434278,434375,L1PA8,1,97
1,434355,434452,L1PA8,1,97
1,434355,434452,L1PA8,1,97
1,434432,434529,L1PA8,1,97
1,434432,434529,L1PA8,1,97
1,434509,434606,L1PA8,1,97
1,434509,434606,L1PA8,1,97
1,434586,434683,L1PA8,1,97
1,434586,434683,L1PA8,1,97
1,434663,434760,L1PA8,1,97
1,434663,434760,L1PA8,1,97
1,434740,434837,L1PA8,1,97
1,434740,434837,L1PA8,1,97
1,434817,434893,L1PA8,1,76
1,434817,434893,L1PA8,1,76
1,434894,435108,L1PA10,1,214
1,434894,435108,L1PA10,1,214
1,435109,435126,L1PA8,1,17
1,435109,435126,L1PA8,1,17
1,435128,435565,L1MEd,-1,437
1,435128,435565,L1MEd,-1,437
1,435433,435450,dust,0,17
1,435573,435666,GA-rich,1,93
1,435581,435666,dust,0,85
1,435753,435850,L1PA5,1,97
1,435753,435850,L1PA5,1,97
1,435822,435878,dust,0,56
1,436298,437125,L1M2,1,827
1,436298,437125,L1M2,1,827
1,436387,436400,dust,0,13
1,437133,437253,ERVL-int,1,120
1,437133,437253,ERVL-int,1,120
1,437255,437746,L1MA7,1,491
1,437255,437746,L1MA7,1,491
1,437750,437759,dust,0,9
1,437763,438484,L1PA4,-1,721
1,437763,438484,L1PA4,-1,721
1,438485,438662,L1PA4,1,177
1,438485,438662,L1PA4,1,177
1,438501,438522,dust,0,21
1,438632,438684,dust,0,52
1,438654,438684,trf,0,30
1,438682,439766,L1MA7,1,1084
1,438682,439766,L1MA7,1,1084
1,439403,439410,dust,0,7
1,440917,440924,dust,0,7
1,440936,447357,L1PA7,1,6421
1,440936,447357,L1PA7,1,6421
1,441339,441353,dust,0,14
1,443573,443580,dust,0,7
1,444019,444027,dust,0,8
1,444417,444437,dust,0,20
1,444933,444946,dust,0,13
1,447349,447357,dust,0,8
1,448109,449613,L1MA7,1,1504
1,448109,449613,L1MA7,1,1504
1,448713,448743,dust,0,30
1,449890,450014,L1MC,1,124
1,449890,450014,L1MC,1,124
1,449998,450555,L1M4,1,557
1,449998,450555,L1M4,1,557
1,453499,453630,MIR3,-1,131
1,453499,453630,MIR3,-1,131
1,454124,454140,dust,0,16
1,454754,454803,dust,0,49
1,454968,455075,trf,0,107
1,455112,455212,MIRc,1,100
1,455112,455212,MIRc,1,100
1,455505,455667,trf,0,162
1,455610,455759,MIRb,1,149
1,455610,455759,MIRb,1,149
1,455768,455816,L1MA4,1,48
1,455768,455816,L1MA4,1,48
1,455833,456082,L1MA4,1,249
1,455833,456082,L1MA4,1,249
1,456074,456147,dust,0,73
1,456112,456132,trf,0,20
1,456129,456265,MIRb,1,136
1,456129,456265,MIRb,1,136
1,456149,456176,trf,0,27
1,456424,456441,dust,0,17
1,456576,456589,dust,0,13
1,457114,457197,AluSz,1,83
1,457114,457197,AluSz,1,83
1,458096,458285,L1MEc,1,189
1,458096,458285,L1MEc,1,189
1,458247,458289,trf,0,42
1,458256,458289,dust,0,33
1,458398,458451,L2c,1,53
1,458398,458451,L2c,1,53
1,459679,459838,MIRb,-1,159
1,459679,459838,MIRb,-1,159
1,460643,460690,AT_rich,1,47
1,460864,460897,dust,0,33
1,460873,461293,L1M7,1,420
1,460873,461293,L1M7,1,420
1,461306,461320,dust,0,14
1,461319,461359,L1M7,1,40
1,461319,461359,L1M7,1,40
1,461360,461504,FLAM_C,1,144
1,461360,461504,FLAM_C,1,144
1,461486,461519,dust,0,33
1,461505,461857,L1M7,1,352
1,461505,461857,L1M7,1,352
1,461738,461794,dust,0,56
1,462041,462729,L2c,-1,688
1,462041,462729,L2c,-1,688
1,462744,463010,L2b,1,266
1,462744,463010,L2b,1,266
1,463226,463465,MLT1H1,1,239
1,463226,463465,MLT1H1,1,239
1,463466,463823,THE1B,-1,357
1,463466,463823,THE1B,-1,357
1,463824,465387,THE1B-int,-1,1563
1,463824,465387,THE1B-int,-1,1563
1,465388,465747,THE1B,-1,359
1,465388,465747,THE1B,-1,359
1,465748,466024,MLT1H1,1,276
1,465748,466024,MLT1H1,1,276
1,465980,465987,dust,0,7
1,466025,466156,MLT1H1-int,1,131
1,466025,466156,MLT1H1-int,1,131
1,466172,466423,MLT1H1-int,1,251
1,466172,466423,MLT1H1-int,1,251
1,466428,466588,LTR64,-1,160
1,466428,466588,LTR64,-1,160
1,466591,466952,L1PA14,1,361
1,466591,466952,L1PA14,1,361
1,466931,466964,dust,0,33
1,467089,467392,AluSq2,1,303
1,467089,467392,AluSq2,1,303
1,467375,467392,dust,0,17
1,467446,467496,trf,0,50
1,467892,467961,L2a,1,69
1,467892,467961,L2a,1,69
1,468053,468590,L2b,1,537
1,468053,468590,L2b,1,537
1,469700,470109,MLT1F2,1,409
1,469700,470109,MLT1F2,1,409
1,469869,469912,dust,0,43
1,470210,470525,L1ME3E,1,315
1,470210,470525,L1ME3E,1,315
1,470243,470267,dust,0,24
1,470477,470484,dust,0,7
1,470553,470578,dust,0,25
1,471064,471200,LTR33B,1,136
1,471064,471200,LTR33B,1,136
1,471349,471451,L2,-1,102
1,471349,471451,L2,-1,102
1,471583,471720,MER65D,1,137
1,471583,471720,MER65D,1,137
1,471796,472076,MER65D,1,280
1,471796,472076,MER65D,1,280
1,472099,472215,L1M5,-1,116
1,472099,472215,L1M5,-1,116
1,472380,473038,L2a,1,658
1,472380,473038,L2a,1,658
1,473039,473235,L1ME3E,1,196
1,473039,473235,L1ME3E,1,196
1,473229,473615,L1ME3E,1,386
1,473229,473615,L1ME3E,1,386
1,473618,474107,MLT1D,1,489
1,473618,474107,MLT1D,1,489
1,474108,475113,L1ME3E,1,1005
1,474108,475113,L1ME3E,1,1005
1,474823,474875,dust,0,52
1,475281,475344,dust,0,63
1,475445,475490,dust,0,45
1,475446,475490,AT_rich,1,44
1,475538,475590,dust,0,52
1,475575,475955,THE1D,-1,380
1,475575,475955,THE1D,-1,380
1,476356,476363,dust,0,7
1,476519,476530,dust,0,11
1,476981,477150,dust,0,169
1,476981,477150,trf,0,169
1,476985,477150,trf,0,165
1,476989,477150,(TA)n,1,161
1,477285,477578,AluY,-1,293
1,477285,477297,dust,0,12
1,477285,477578,AluY,-1,293
1,477643,477731,dust,0,88
1,477651,477724,AT_rich,1,73
1,479088,479142,(TATATG)n,1,54
1,479099,479142,dust,0,43
1,479182,479278,L1MA5,1,96
1,479182,479278,L1MA5,1,96
1,479409,479456,trf,0,47
1,479643,479713,L2a,1,70
1,479643,479713,L2a,1,70
1,479720,479832,L2a,1,112
1,479720,479832,L2a,1,112
1,479844,480394,L2c,1,550
1,479844,480394,L2c,1,550
1,480558,480859,AluJb,1,301
1,480558,480859,AluJb,1,301
1,480836,480859,dust,0,23
1,480836,480859,trf,0,23
1,481602,481654,dust,0,52
1,481909,481972,dust,0,63
1,481948,481975,AT_rich,1,27
1,482006,482056,dust,0,50
1,482024,482224,L1MA5,1,200
1,482024,482224,L1MA5,1,200
1,482211,482228,dust,0,17
1,482226,482976,L1M4,1,750
1,482226,482976,L1M4,1,750
1,482442,482450,dust,0,8
1,482906,482990,dust,0,84
1,483118,483145,AT_rich,1,27
1,483121,483128,dust,0,7
1,483532,483641,L2a,-1,109
1,483532,483641,L2a,-1,109
1,483766,484035,AluSz,-1,269
1,483766,484035,AluSz,-1,269
1,484472,484579,L2a,-1,107
1,484472,484579,L2a,-1,107
1,484580,484878,AluSq2,-1,298
1,484580,484596,dust,0,16
1,484580,484878,AluSq2,-1,298
1,484879,485004,L2a,-1,125
1,484879,485004,L2a,-1,125
1,485368,485660,AluSx,-1,292
1,485368,485394,dust,0,26
1,485368,485660,AluSx,-1,292
1,485514,485553,trf,0,39
1,485663,485679,dust,0,16
1,485665,485773,FLAM_C,-1,108
1,485665,485773,FLAM_C,-1,108
1,485776,485878,AluJo,1,102
1,485776,485878,AluJo,1,102
1,485894,485985,L1M2c,1,91
1,485894,485985,L1M2c,1,91
1,485955,485985,dust,0,30
1,485986,486300,AluSg,1,314
1,485986,486300,AluSg,1,314
1,486272,486287,dust,0,15
1,486301,486527,L1M2c,1,226
1,486301,486527,L1M2c,1,226
1,486525,486739,L1M2,1,214
1,486525,486739,L1M2,1,214
1,486740,486963,AluSq2,1,223
1,486740,486963,AluSq2,1,223
1,486943,486978,dust,0,35
1,486943,486979,trf,0,36
1,486952,486979,trf,0,27
1,486953,486979,trf,0,26
1,486964,486987,L1M2,1,23
1,486964,486987,L1M2,1,23
1,490053,490357,AluSg,-1,304
1,490053,490077,dust,0,24
1,490053,490077,trf,0,24
1,490053,490357,AluSg,-1,304
1,490821,490848,dust,0,27
1,492183,492488,trf,0,305
1,492183,492490,trf,0,307
1,492598,492667,trf,0,69
1,493461,493553,trf,0,92
1,494024,494140,trf,0,116
1,494035,494269,trf,0,234
1,494580,494659,trf,0,79
1,494910,495329,MER1A,-1,419
1,494910,495329,MER1A,-1,419
1,495596,495748,LTR41,-1,152
1,495596,495748,LTR41,-1,152
1,495752,496027,AluJr,1,275
1,495752,496027,AluJr,1,275
1,496031,496251,L1ME4c,1,220
1,496031,496251,L1ME4c,1,220
1,496252,496392,AluJb,-1,140
1,496252,496392,AluJb,-1,140
1,496629,496928,AluJr,-1,299
1,496629,496928,AluJr,-1,299
1,497038,497139,MER8,-1,101
1,497038,497139,MER8,-1,101
1,497140,497327,AluJb,1,187
1,497140,497327,AluJb,1,187
1,497309,497327,dust,0,18
1,497873,497882,dust,0,9
1,497906,498062,AluJr,1,156
1,497906,498062,AluJr,1,156
1,498317,498736,MER1A,-1,419
1,498317,498736,MER1A,-1,419
1,499022,499101,FLAM_A,1,79
1,499022,499101,FLAM_A,1,79
1,499104,499393,AluJo,1,289
1,499104,499393,AluJo,1,289
1,499175,499198,trf,0,23
1,499377,499393,dust,0,16
1,499394,499899,MER21C,1,505
1,499394,499899,MER21C,1,505
1,499900,500206,AluJb,-1,306
1,499900,500206,AluJb,-1,306
1,499904,499911,dust,0,7
1,500063,500090,dust,0,27
1,500207,500276,MER21C,1,69
1,500207,500276,MER21C,1,69
1,500277,500579,AluJr,1,302
1,500277,500579,AluJr,1,302
1,500580,500880,MER21C,1,300
1,500580,500880,MER21C,1,300
1,500917,501115,MIRb,1,198
1,500917,501115,MIRb,1,198
1,501375,501478,L2b,1,103
1,501375,501478,L2b,1,103
1,501774,501881,AluJb,-1,107
1,501774,501881,AluJb,-1,107
1,501915,502039,AluJr,1,124
1,501915,502039,AluJr,1,124
1,502053,502484,MER1A,-1,431
1,502053,502484,MER1A,-1,431
1,502787,502837,LTR41,-1,50
1,502787,502849,LTR41,-1,62
1,502850,503134,AluJb,1,284
1,502850,503134,AluJb,1,284
1,503139,503172,dust,0,33
1,503139,503183,trf,0,44
1,503139,503172,(TA)n,1,33
1,503172,503198,LTR41,-1,26
1,503173,503198,LTR41,-1,25
1,503199,503494,AluSp,1,295
1,503199,503494,AluSp,1,295
1,503481,503494,dust,0,13
1,503495,503580,LTR41,-1,85
1,503495,503580,LTR41,-1,85
1,503581,503888,AluJr,1,307
1,503581,503888,AluJr,1,307
1,503701,503708,dust,0,7
1,503868,503888,dust,0,20
1,504220,504478,L2b,1,258
1,504220,504478,L2b,1,258
1,504506,504598,L2b,1,92
1,504506,504598,L2b,1,92
1,504663,504821,MLT1D,1,158
1,504663,504821,MLT1D,1,158
1,504823,505116,AluJr,1,293
1,504823,505116,AluJr,1,293
1,505370,505644,AluJr,1,274
1,505370,505644,AluJr,1,274
1,505632,505644,dust,0,12
1,505655,505756,AluJb,-1,101
1,505657,505751,AluJr4,-1,94
1,505757,506061,AluSx,1,304
1,505757,506026,AluSx,1,269
1,506029,506079,dust,0,50
1,506029,506080,trf,0,51
1,506029,506073,trf,0,44
1,506029,506073,(CAA)n,1,44
1,506074,506133,AluJb,-1,59
1,506078,506133,AluJo,-1,55
1,506190,506199,dust,0,9
1,506193,506223,L1M4,1,30
1,506193,506223,L1MB8,1,30
1,506224,506515,AluJb,1,291
1,506224,506515,AluJb,1,291
1,506506,506515,dust,0,9
1,506516,506603,L1M4,1,87
1,506516,506603,L1MB8,1,87
1,506638,506748,AluJo,-1,110
1,506638,506748,FLAM_A,-1,110
1,506749,507367,L1MB8,1,618
1,506749,507367,L1MB8,1,618
1,506922,506941,trf,0,19
1,507389,507690,AluJr,1,301
1,507389,507690,AluJr,1,301
1,507694,507808,Tigger12,-1,114
1,507694,507808,Tigger12,-1,114
1,507993,508300,AluSq2,1,307
1,507993,508300,AluSq2,1,307
1,508277,508296,dust,0,19
1,508280,508300,trf,0,20
1,508512,508605,LTR37A,-1,93
1,508512,508605,LTR37A,-1,93
1,508751,509046,AluJo,-1,295
1,508751,509046,AluJo,-1,295
1,508914,508927,dust,0,13
1,509047,509073,AT_rich,1,26
1,509049,509087,dust,0,38
1,509075,509206,AluJr,-1,131
1,509075,509206,AluJr,-1,131
1,509306,509913,L2a,1,607
1,509306,509913,L2a,1,607
1,509915,510073,AluJb,-1,158
1,509915,510073,AluJb,-1,158
1,510074,510358,AluSg7,-1,284
1,510074,510089,dust,0,15
1,510074,510358,AluSg7,-1,284
1,510359,510485,AluJb,-1,126
1,510359,510485,AluJb,-1,126
1,510369,510377,dust,0,8
1,510507,510863,MLT1D,-1,356
1,510507,510863,MLT1D,-1,356
1,510867,511157,AluJr,1,290
1,510867,511157,AluJr,1,290
1,511158,511416,MER21C,1,258
1,511158,511416,MER21C,1,258
1,511417,511711,AluSq2,-1,294
1,511417,511428,dust,0,11
1,511417,511711,AluSq2,-1,294
1,511712,512021,MER21C,1,309
1,511712,512021,MER21C,1,309
1,512022,512327,AluJo,1,305
1,512022,512327,AluJo,1,305
1,512309,512327,dust,0,18
1,512328,512627,MER21C,1,299
1,512328,512627,MER21C,1,299
1,512629,513691,MER11B,1,1062
1,512629,513691,MER11B,1,1062
1,513737,513931,MIRb,1,194
1,513737,513931,MIRb,1,194
1,514151,514209,(CACCC)n,1,58
1,514153,514206,dust,0,53
1,514447,514461,dust,0,14
1,514586,514607,dust,0,21
1,514587,514706,AluJb,-1,119
1,514587,514706,AluJb,-1,119
1,514709,515009,AluJo,-1,300
1,514709,515009,AluJo,-1,300
1,514872,514890,dust,0,18
1,515049,515189,L1ME4b,1,140
1,515049,515189,L1ME4b,1,140
1,515311,515349,AT_rich,1,38
1,515420,515727,AluJr,1,307
1,515420,515727,AluJr,1,307
1,515538,515556,dust,0,18
1,515700,515713,dust,0,13
1,515775,515942,AluSz,1,167
1,515775,515942,AluSz,1,167
1,515951,516087,L1ME4c,1,136
1,515951,516087,L1ME4c,1,136
1,516088,516095,dust,0,7
1,516091,516210,AluJr4,-1,119
1,516091,516210,AluJr4,-1,119
1,516211,516334,L1ME4c,1,123
1,516211,516334,L1ME4c,1,123
1,516357,516373,dust,0,16
1,516554,516594,MIRb,1,40
1,516554,516594,MIRb,1,40
1,516596,516603,dust,0,7
1,516699,516806,MER8,-1,107
1,516699,516806,MER8,-1,107
1,516818,516962,AluJb,1,144
1,516818,516962,AluJb,1,144
1,517101,517221,Charlie29a,-1,120
1,517101,517221,Charlie29a,-1,120
1,517305,517588,AluJr,1,283
1,517305,517588,AluJr,1,283
1,517590,517629,dust,0,39
1,517590,517629,trf,0,39
1,517590,517629,(CA)n,1,39
1,517952,518175,AluSx1,1,223
1,517952,518175,AluSx1,1,223
1,519068,519083,dust,0,15
1,519896,520301,L1MC5a,1,405
1,519896,520301,L1MC5a,1,405
1,520164,520172,dust,0,8
1,520312,520403,L1MC5a,1,91
1,520312,520403,L1MC5a,1,91
1,520712,520777,MSTD,-1,65
1,520712,520777,MSTD,-1,65
1,520766,520995,dust,0,229
1,520769,520921,trf,0,152
1,520778,520951,GA-rich,1,173
1,520793,520937,trf,0,144
1,520794,520940,trf,0,146
1,520952,520988,G-rich,1,36
1,520990,521307,MSTD,-1,317
1,520990,521307,MSTD,-1,317
1,522411,522425,dust,0,14
1,522444,522749,AluSq2,1,305
1,522444,522700,AluSx,1,256
1,522725,522749,dust,0,24
1,522726,522749,trf,0,23
1,522726,522749,(CAAAA)n,1,23
1,522955,523291,AluSq2,1,336
1,522955,523291,AluSq2,1,336
1,523000,523066,trf,0,66
1,523270,523291,dust,0,21
1,523270,523291,trf,0,21
1,523395,523408,dust,0,13
1,523603,523906,AluSx1,1,303
1,523603,523906,AluSx1,1,303
1,523884,523906,dust,0,22
1,523884,523906,trf,0,22
1,524652,524930,AluSx1,1,278
1,524652,524930,AluSx1,1,278
1,524964,525099,MIRb,-1,135
1,524964,525099,MIRb,-1,135
1,525187,525227,dust,0,40
1,525730,526029,AluSp,-1,299
1,525730,526029,AluSp,-1,299
1,526091,526385,AluSg7,1,294
1,526091,526385,AluSg7,1,294
1,526370,526377,dust,0,7
1,527081,527382,AluYh3,1,301
1,527081,527382,AluYh3,1,301
1,527168,527202,dust,0,34
1,527363,527382,dust,0,19
1,527511,527938,MLT1D,1,427
1,527511,527938,MLT1D,1,427
1,527970,528275,AluSz,1,305
1,527970,528275,AluSz,1,305
1,528254,528276,dust,0,22
1,528453,528744,AluSz6,-1,291
1,528453,528744,AluSz6,-1,291
1,528456,528467,dust,0,11
1,529065,529072,dust,0,7
1,529489,529530,Charlie4z,1,41
1,529489,529529,Charlie4z,1,40
1,529530,529551,dust,0,21
1,529530,529549,trf,0,19
1,529530,529831,AluSq2,-1,301
1,529531,529831,AluSq2,-1,300
1,529832,529932,Charlie4z,1,100
1,529832,529932,Charlie4z,1,100
1,529978,530006,trf,0,28
1,530690,530707,dust,0,17
1,530691,530741,AluSq2,-1,50
1,530691,530741,AluSq2,-1,50
1,531002,531084,MIR1_Amn,-1,82
1,531002,531084,MIR1_Amn,-1,82
1,531256,531291,L2c,1,35
1,531256,531291,L2c,1,35
1,531428,531508,MIRb,-1,80
1,531428,531508,MIRb,-1,80
1,532977,533112,AluSx,1,135
1,532977,533281,trf,0,304
1,532977,533112,AluSx,1,135
1,533113,533415,AluSp,1,302
1,533113,533415,AluSp,1,302
1,533395,533415,dust,0,20
1,533416,533512,AluSx,1,96
1,533416,533512,AluSx,1,96
1,533493,533520,dust,0,27
1,533493,533520,trf,0,27
1,533513,533544,A-rich,1,31
1,533753,534065,AluSx,1,312
1,533753,534065,AluSx,1,312
1,534034,534066,dust,0,32
1,534034,534069,trf,0,35
1,534037,534065,trf,0,28
1,534186,534478,AluSp,-1,292
1,534186,534198,dust,0,12
1,534186,534478,AluSp,-1,292
1,534502,534818,AluSx1,1,316
1,534502,534818,AluSx1,1,316
1,534788,534878,dust,0,90
1,534790,534818,trf,0,28
1,534948,535032,MIRb,-1,84
1,534948,535032,MIRb,-1,84
1,535888,535916,AT_rich,1,28
1,535989,585988,dust,0,49999
1,586338,586407,MER4D1,-1,69
1,586338,586407,MER4D1,-1,69
1,586408,586556,MER4A,1,148
1,586408,586556,MER4A,1,148
1,586553,586826,MER4CL34,1,273
1,586553,586826,MER4CL34,1,273
1,586836,587631,MER4D1,-1,795
1,586836,587631,MER4D1,-1,795
1,587718,587805,MIRb,1,87
1,587718,587805,MIRb,1,87
1,588058,588110,dust,0,52
1,588067,588127,C-rich,1,60
1,588463,588616,Charlie30a,-1,153
1,588463,588616,Charlie30a,-1,153
1,588469,588483,dust,0,14
1,588803,588836,dust,0,33
1,588803,588863,(CA)n,1,60
1,588861,588910,trf,0,49
1,589004,589268,MER31B,1,264
1,589004,589268,MER31B,1,264
1,589269,589555,AluJr,-1,286
1,589269,589284,dust,0,15
1,589269,589555,AluJr,-1,286
1,589562,590374,L1MA4,1,812
1,589562,590374,L1MA4,1,812
1,590375,590674,AluSx3,1,299
1,590375,590674,AluSx3,1,299
1,590655,590674,dust,0,19
1,590678,590990,AluSc,1,312
1,590678,590990,AluSc,1,312
1,590966,591006,dust,0,40
1,590969,590992,trf,0,23
1,590991,591452,L1MA4,1,461
1,590991,591452,L1MA4,1,461
1,591453,591763,AluY,1,310
1,591453,591763,AluY,1,310
1,591734,591751,dust,0,17
1,591764,591984,L1MA4,1,220
1,591764,591984,L1MA4,1,220
1,591974,591990,dust,0,16
1,592050,592172,AluJb,1,122
1,592050,592172,AluJb,1,122
1,592154,592204,dust,0,50
1,593117,593170,trf,0,53
1,593400,593498,MER112,-1,98
1,593400,593498,MER112,-1,98
1,593923,594096,MIR3,-1,173
1,593923,594096,MIR3,-1,173
1,594469,594685,L1ME4c,-1,216
1,594469,594685,L1ME4c,-1,216
1,594740,595208,Ricksha_0,1,468
1,594740,595208,Ricksha_0,1,468
1,594797,594836,trf,0,39
1,595320,595397,MIRb,1,77
1,595320,595397,MIRb,1,77
1,595364,595414,MIR3,1,50
1,595364,595414,MIR3,1,50
1,595508,595617,trf,0,109
1,595663,595726,Tigger4b,1,63
1,595663,595726,Tigger4b,1,63
1,596011,596173,Charlie20a,1,162
1,596011,596173,Charlie20a,1,162
1,596177,596333,(CATATA)n,1,156
1,596217,596607,trf,0,390
1,596248,596369,trf,0,121
1,596278,596353,dust,0,75
1,596280,596624,(CA)n,1,344
1,596309,596524,trf,0,215
1,596309,596524,trf,0,215
1,596431,596625,trf,0,194
1,596493,596546,dust,0,53
1,596555,596849,trf,0,294
1,596641,597006,(CA)n,1,365
1,596643,597016,trf,0,373
1,596702,596804,trf,0,102
1,596745,596980,trf,0,235
1,596941,596983,dust,0,42
1,596949,597068,trf,0,119
1,597044,597131,dust,0,87
1,597052,597105,trf,0,53
1,597053,597213,(CA)n,1,160
1,597260,597361,Charlie20a,1,101
1,597260,597361,Charlie20a,1,101
1,597362,597657,AluSx1,-1,295
1,597362,597657,AluSx1,-1,295
1,597371,597378,dust,0,7
1,597658,597681,Charlie20a,1,23
1,597658,597681,Charlie20a,1,23
1,597686,597699,dust,0,13
1,597699,597827,L1MD3,-1,128
1,597699,597827,L1MD3,-1,128
1,597795,598734,trf,0,939
1,598735,599301,L1MD3,-1,566
1,598735,599301,L1MD3,-1,566
1,598935,598945,dust,0,10
1,599288,599330,dust,0,42
1,599288,599327,trf,0,39
1,599288,599327,trf,0,39
1,599289,599330,trf,0,41
1,599302,599607,AluSq,-1,305
1,599302,599607,AluSq,-1,305
1,599608,599678,L1MD3,-1,70
1,599608,599678,L1MD3,-1,70
1,599680,599712,dust,0,32
1,599683,599860,AluYf1,-1,177
1,599683,599711,trf,0,28
1,599683,599860,AluYf1,-1,177
1,599872,600425,L1MD3,-1,553
1,599872,599948,L1MD3,-1,76
1,599949,599988,dust,0,39
1,599949,599988,trf,0,39
1,599949,599988,(TG)n,1,39
1,599989,600425,L1MD3,-1,436
1,600343,600832,trf,0,489
1,600422,600498,L1MD3,-1,76
1,600422,600498,L1MD3,-1,76
1,600501,600577,L1MD3,-1,76
1,600501,600577,L1MD3,-1,76
1,600642,601176,trf,0,534
1,600659,600741,L1MD3,-1,82
1,600659,600741,L1MD3,-1,82
1,600738,600820,L1MD3,-1,82
1,600738,600820,L1MD3,-1,82
1,600799,600936,trf,0,137
1,600822,600900,dust,0,78
1,601005,601031,dust,0,26
1,601174,601768,L1MD3,-1,594
1,601174,601768,L1MD3,-1,594
1,602185,602360,dust,0,175
1,602186,602359,trf,0,173
1,602186,602359,C-rich,1,173
1,602195,602359,trf,0,164
1,602832,603444,MER39B,-1,612
1,602832,603444,MER39B,-1,612
1,603760,603787,dust,0,27
1,604123,604421,AluY,1,298
1,604123,604421,AluY,1,298
1,604402,604419,dust,0,17
1,604686,605430,L1ME1,1,744
1,604686,605430,L1ME1,1,744
1,605579,605752,L1ME1,1,173
1,605579,605752,L1ME1,1,173
1,605778,605788,dust,0,10
1,606515,606641,trf,0,126
1,606515,606649,trf,0,134
1,606537,606642,trf,0,105
1,606684,606709,trf,0,25
1,607266,607313,dust,0,47
1,607266,607314,GA-rich,1,48
1,607638,607919,(TCTA)n,1,281
1,609341,610761,trf,0,1420
1,611280,611389,dust,0,109
1,611281,611455,(TG)n,1,174
1,611307,612522,trf,0,1215
1,611399,611487,dust,0,88
1,611482,611661,(TG)n,1,179
1,611490,611551,dust,0,61
1,611584,611661,dust,0,77
1,611710,611869,(TG)n,1,159
1,611721,611807,dust,0,86
1,611813,611903,dust,0,90
1,611905,611967,dust,0,62
1,612000,612077,dust,0,77
1,612022,612181,(TG)n,1,159
1,612137,612181,dust,0,44
1,612229,612317,dust,0,88
1,612320,612380,dust,0,60
1,612480,612538,dust,0,58
1,612611,612876,AluJr4,1,265
1,612611,612876,AluJr4,1,265
1,612867,612924,dust,0,57
1,612877,612940,AT_rich,1,63
1,613121,613420,AluSq2,1,299
1,613121,613420,AluSq2,1,299
1,613404,613420,dust,0,16
1,614726,615025,AluSx1,1,299
1,614726,615025,AluSx1,1,299
1,615939,616027,MLT1K,1,88
1,615939,616027,MLT1K,1,88
1,616033,616689,LTR9B,1,656
1,616033,616689,LTR9B,1,656
1,616791,616961,MLT1K,1,170
1,616791,616961,MLT1K,1,170
1,617107,617288,MER5A,-1,181
1,617107,617288,MER5A,-1,181
1,617612,617731,MIRb,-1,119
1,617612,617731,MIRb,-1,119
1,617974,618322,MER4E1,1,348
1,617974,618322,MER4E1,1,348
1,617991,618001,dust,0,10
1,618323,618622,AluSg4,-1,299
1,618323,618622,AluSg4,-1,299
1,618327,618336,dust,0,9
1,618623,619044,MER4E1,1,421
1,618623,619044,MER4E1,1,421
1,619216,619309,L2c,-1,93
1,619216,619309,L2c,-1,93
1,619884,620094,L1M5,-1,210
1,619884,620094,L1M5,-1,210
1,620225,620428,MIRc,-1,203
1,620225,620428,MIRc,-1,203
1,620526,620596,Charlie4z,-1,70
1,620526,620596,Charlie4z,-1,70
1,620598,621054,MLT1E3,1,456
1,620598,621054,MLT1E3,1,456
1,621209,621367,AluJo,1,158
1,621209,621367,AluJo,1,158
1,621354,621367,dust,0,13
1,622612,622702,MIRc,1,90
1,622612,622702,MIRc,1,90
1,622928,623095,MER5B,-1,167
1,622928,623095,MER5B,-1,167
1,623672,623699,dust,0,27
1,623672,623699,trf,0,27
1,623672,623699,(TG)n,1,27
1,624275,624429,L2a,1,154
1,624275,624429,L2a,1,154
1,624434,624534,trf,0,100
1,624434,624526,G-rich,1,92
1,624439,624534,dust,0,95
1,624527,624700,MIRb,1,173
1,624527,624700,MIRb,1,173
1,625161,625605,LTR37B,-1,444
1,625161,625605,LTR37B,-1,444
1,625607,625900,AluSq,-1,293
1,625607,625616,dust,0,9
1,625607,625900,AluSq,-1,293
1,626003,626157,MLT1O,-1,154
1,626003,626157,MLT1O,-1,154
1,626517,626573,AluSz6,-1,56
1,626517,626534,dust,0,17
1,626517,626573,AluSz6,-1,56
1,626587,626632,MSTA,1,45
1,626587,626632,MSTA,1,45
1,626633,626941,AluSg,-1,308
1,626633,626656,trf,0,23
1,626633,626781,AluSx,-1,148
1,626637,626656,dust,0,19
1,626782,626821,dust,0,39
1,626782,626821,trf,0,39
1,626782,626821,(TG)n,1,39
1,626822,626941,AluSx,-1,119
1,626942,627005,MSTA,1,63
1,626942,627005,MSTA,1,63
1,627010,627153,MIRb,1,143
1,627010,627153,MIRb,1,143
1,627422,627529,L2c,1,107
1,627422,627529,L2c,1,107
1,627934,627973,trf,0,39
1,628209,628354,MIRb,-1,145
1,628209,628354,MIRb,-1,145
1,634980,635098,MER103C,-1,118
1,634980,635098,MER103C,-1,118
1,635156,635216,MER103C,-1,60
1,635156,635216,MER103C,-1,60
1,635390,635534,MIRb,-1,144
1,635390,635534,MIRb,-1,144
1,635543,635856,LTR39,-1,313
1,635543,635856,LTR39,-1,313
1,635857,636155,AluSz6,1,298
1,635857,636155,AluSz6,1,298
1,636156,636458,LTR39,-1,302
1,636156,636458,LTR39,-1,302
1,636453,636468,dust,0,15
1,636459,636578,L1PA4,-1,119
1,636459,636578,L1PA4,-1,119
1,636579,636722,LTR39,-1,143
1,636579,636722,LTR39,-1,143
1,637214,637415,L2a,-1,201
1,637214,637415,L2a,-1,201
1,637472,637479,dust,0,7
1,637735,638016,AluSg,1,281
1,637735,638016,AluSg,1,281
1,638016,638041,dust,0,25
1,638017,638041,trf,0,24
1,638017,638041,(TAAA)n,1,24
1,638234,638361,LTR33,1,127
1,638234,638361,LTR33,1,127
1,638662,638882,MIR,1,220
1,638662,638882,MIR,1,220
1,638771,638779,dust,0,8
1,639258,639520,L5,1,262
1,639258,639520,L5,1,262
1,639830,640120,AluSc,-1,290
1,639830,639842,dust,0,12
1,639830,640120,AluSc,-1,290
1,640167,640472,L2,1,305
1,640167,640472,L2,1,305
1,640609,640898,MLT1H,-1,289
1,640609,640898,MLT1H,-1,289
1,640899,641219,AluY,-1,320
1,640899,640928,dust,0,29
1,640899,640925,trf,0,26
1,640899,641219,AluY,-1,320
1,641078,641101,dust,0,23
1,641220,641265,MLT1H,-1,45
1,641220,641265,MLT1H,-1,45
1,641730,641760,(CAA)n,1,30
1,641803,641884,L1ME4a,-1,81
1,641803,641884,L1ME4a,-1,81
1,643203,643257,(TG)n,1,54
1,643210,643257,dust,0,47
1,643727,643735,dust,0,8
1,643990,644147,MLT1I,1,157
1,643990,644147,MLT1I,1,157
1,644211,644273,MLT1I,1,62
1,644211,644273,MLT1I,1,62
1,645185,645267,dust,0,82
1,645188,645222,trf,0,34
1,645188,645222,(TTTA)n,1,34
1,645222,645267,trf,0,45
1,645238,645548,AluSg4,-1,310
1,645238,645548,AluSg4,-1,310
1,645671,645865,MER124,1,194
1,645671,645865,MER124,1,194
1,645875,645947,L3,1,72
1,645875,645947,L3,1,72
1,646036,646443,MamRep605,-1,407
1,646036,646443,MamRep605,-1,407
1,646495,646573,MamRep605,-1,78
1,646495,646573,MamRep605,-1,78
1,647211,647512,AluSz,1,301
1,647211,647512,AluSz,1,301
1,647491,647508,dust,0,17
1,647570,647853,AluJr,1,283
1,647570,647853,AluJr,1,283
1,647673,647681,dust,0,8
1,647836,647853,dust,0,17
1,647882,647984,L1M5,1,102
1,647882,647984,L1M5,1,102
1,647985,648285,AluSx,1,300
1,647985,648285,AluSx,1,300
1,648273,648315,trf,0,42
1,648286,648357,L1M5,1,71
1,648286,648357,L1M5,1,71
1,648807,648864,trf,0,57
1,648818,648891,trf,0,73
1,648828,648864,trf,0,36
1,648868,649004,MIRb,-1,136
1,648868,649004,MIRb,-1,136
1,649007,649140,L3,1,133
1,649007,649140,L3,1,133
1,649185,649193,dust,0,8
1,649200,649506,AluSx3,1,306
1,649200,649511,AluSx,1,311
1,649479,649511,dust,0,32
1,649481,649504,trf,0,23
1,649599,649690,LTR33,-1,91
1,649599,649691,LTR33,-1,92
1,649692,649840,MSTB1,1,148
1,649692,649840,MSTB1,1,148
1,649841,650132,AluSq,-1,291
1,649841,649853,dust,0,12
1,649841,650132,AluSq,-1,291
1,650133,650388,MSTB1,1,255
1,650133,650383,MSTB1,1,250
1,650384,650423,dust,0,39
1,650384,650423,trf,0,39
1,650384,650426,(CA)n,1,42
1,650427,650442,MSTB1,1,15
1,650443,650481,LTR33,-1,38
1,650565,650733,LTR33,-1,168
1,650565,650733,LTR33,-1,168
1,650745,650947,L3,1,202
1,650745,650947,L3,1,202
1,651063,651520,Tigger5,1,457
1,651063,651520,Tigger5,1,457
1,651523,652097,L1M4,1,574
1,651523,652097,L1M4,1,574
1,651652,651707,dust,0,55
1,651961,651977,dust,0,16
1,652108,653632,L1MC5a,1,1524
1,652108,653616,L1MC5a,1,1508
1,652448,652470,dust,0,22
1,653336,653510,trf,0,174
1,653617,653792,dust,0,175
1,653617,653790,(GAAA)n,1,173
1,653620,653790,trf,0,170
1,653791,655449,L1MC5a,1,1658
1,653825,655449,L1MC5a,1,1624
1,653847,653855,dust,0,8
1,655449,655736,L1MC5a,1,287
1,655449,655736,L1MC5a,1,287
1,655468,655475,dust,0,7
1,655555,655562,dust,0,7
1,655779,656369,L1MC5a,1,590
1,655779,656369,L1MC5a,1,590
1,656395,656425,dust,0,30
1,656395,656468,(TA)n,1,73
1,656569,656832,HAL1M8,1,263
1,656569,656832,HAL1M8,1,263
1,656955,657133,L1ME3B,1,178
1,656955,657133,L1ME3B,1,178
1,657064,657104,dust,0,40
1,657703,657735,AT_rich,1,32
1,657736,657782,L1PA6,-1,46
1,657736,657782,L1PA6,-1,46
1,657783,657810,AT_rich,1,27
1,658190,658197,dust,0,7
1,658724,659073,L2c,-1,349
1,658724,659073,L2c,-1,349
1,659134,659165,AT_rich,1,31
1,659214,659245,dust,0,31
1,659226,659491,L1PA5,-1,265
1,659226,659491,L1PA5,-1,265
1,659495,659727,L2c,-1,232
1,659495,659727,L2c,-1,232
1,659894,659970,L1ME3D,-1,76
1,659894,659970,L1ME3D,-1,76
1,659977,660138,AluJr,1,161
1,659977,660138,AluJr,1,161
1,660126,660138,dust,0,12
1,660165,660749,L1ME3D,-1,584
1,660165,660749,L1ME3D,-1,584
1,660192,660227,trf,0,35
1,660682,660689,dust,0,7
1,660763,660810,dust,0,47
1,660785,660807,(TTTTG)n,1,22
1,660798,661821,L1P4,-1,1023
1,660808,661821,L1P4,-1,1013
1,660867,660875,dust,0,8
1,661872,662612,L1ME3D,-1,740
1,661872,662612,L1ME3D,-1,740
1,662377,662427,trf,0,50
1,662461,662503,dust,0,42
1,662587,662648,dust,0,61
1,662647,662770,L1MA8,-1,123
1,662647,662770,L1MA8,-1,123
1,662771,663506,L1MA2,1,735
1,662771,663506,L1MA2,1,735
1,663507,665488,L1MA8,-1,1981
1,663507,665488,L1MA8,-1,1981
1,663779,663792,dust,0,13
1,664876,664916,dust,0,40
1,665487,665627,L1ME3D,-1,140
1,665487,665627,L1ME3D,-1,140
1,665643,666123,LTR22C2,1,480
1,665643,666123,LTR22C2,1,480
1,666154,666166,dust,0,12
1,666159,667201,L1PA15-16,1,1042
1,666159,667201,L1PA15-16,1,1042
1,666605,666621,dust,0,16
1,667195,667606,L1P4,1,411
1,667195,667606,L1P4,1,411
1,667219,667228,dust,0,9
1,667609,667898,AluSp,1,289
1,667609,667898,AluSp,1,289
1,667898,668083,dust,0,185
1,667898,668052,trf,0,154
1,667899,668023,(TA)n,1,124
1,668024,668509,L1PA8A,1,485
1,668024,668509,L1PA8A,1,485
1,668335,669950,trf,0,1615
1,668489,668585,L1PA8,1,96
1,668489,668585,L1PA8,1,96
1,668565,668662,L1PA8,1,97
1,668565,668662,L1PA8,1,97
1,668642,668739,L1PA8,1,97
1,668642,668739,L1PA8,1,97
1,668719,668816,L1PA8,1,97
1,668719,668816,L1PA8,1,97
1,668796,668892,L1PA8,1,96
1,668796,668892,L1PA8,1,96
1,668872,668969,L1PA8,1,97
1,668872,668969,L1PA8,1,97
1,668949,669046,L1PA8,1,97
1,668949,669046,L1PA8,1,97
1,669026,669123,L1PA8,1,97
1,669026,669123,L1PA8,1,97
1,669103,669200,L1PA8,1,97
1,669103,669200,L1PA8,1,97
1,669180,669277,L1PA8,1,97
1,669180,669277,L1PA8,1,97
1,669257,669354,L1PA8,1,97
1,669257,669354,L1PA8,1,97
1,669334,669431,L1PA8,1,97
1,669334,669431,L1PA8,1,97
1,669411,669508,L1PA8,1,97
1,669411,669508,L1PA8,1,97
1,669488,669585,L1PA8,1,97
1,669488,669585,L1PA8,1,97
1,669565,669662,L1PA8,1,97
1,669565,669662,L1PA8,1,97
1,669642,669739,L1PA8,1,97
1,669642,669739,L1PA8,1,97
1,669719,669816,L1PA8,1,97
1,669719,669816,L1PA8,1,97
1,669796,669870,L1PA11,1,74
1,669796,669870,L1PA11,1,74
1,669873,670087,L1PA10,1,214
1,669873,670087,L1PA10,1,214
1,670107,670544,L1MEd,-1,437
1,670107,670544,L1MEd,-1,437
1,670412,670429,dust,0,17
1,670551,670645,dust,0,94
1,670552,670645,GA-rich,1,93
1,670732,670829,L1PA5,1,97
1,670732,670829,L1PA5,1,97
1,670801,670857,dust,0,56
1,671277,672104,L1M2,1,827
1,671277,672104,L1M2,1,827
1,671366,671379,dust,0,13
1,672112,672246,ERVL-int,1,134
1,672112,672246,ERVL-int,1,134
1,672251,672725,L1MA7,1,474
1,672251,672725,L1MA7,1,474
1,672729,672738,dust,0,9
1,672742,673463,L1PA4,-1,721
1,672742,673463,L1PA4,-1,721
1,673464,673641,L1PA4,1,177
1,673464,673641,L1PA4,1,177
1,673480,673501,dust,0,21
1,673612,673663,dust,0,51
1,673633,673663,trf,0,30
1,673661,674745,L1MA7,1,1084
1,673661,674745,L1MA7,1,1084
1,674382,674389,dust,0,7
1,675893,675900,dust,0,7
1,675912,682333,L1PA7,1,6421
1,675912,682333,L1PA7,1,6421
1,676315,676329,dust,0,14
1,677642,677700,dust,0,58
1,678549,678556,dust,0,7
1,678995,679003,dust,0,8
1,679393,679413,dust,0,20
1,679909,679922,dust,0,13
1,682325,682333,dust,0,8
1,683085,684589,L1MA7,1,1504
1,683085,684589,L1MA7,1,1504
1,683689,683719,dust,0,30
1,684865,684973,L1M2,1,108
1,684865,684973,L1M2,1,108
1,684974,685529,L1M4,1,555
1,684974,685529,L1M4,1,555
1,688475,688606,MIR3,-1,131
1,688475,688606,MIR3,-1,131
1,689098,689114,dust,0,16
1,689728,689777,dust,0,49
1,689942,690049,trf,0,107
1,690093,690185,MIRc,1,92
1,690093,690185,MIRc,1,92
1,690478,690640,trf,0,162
1,690591,690732,MIRb,1,141
1,690591,690732,MIRb,1,141
1,690741,690789,L1MA4,1,48
1,690741,690789,L1MA4,1,48
1,690806,691052,L1MA4,1,246
1,690806,691052,L1MA4,1,246
1,691047,691120,dust,0,73
1,691085,691105,trf,0,20
1,691102,691238,MIRb,1,136
1,691102,691238,MIRb,1,136
1,691397,691404,dust,0,7
1,691547,691560,dust,0,13
1,692085,692168,AluSz,1,83
1,692085,692168,AluSz,1,83
1,693067,693256,L1MEc,1,189
1,693067,693256,L1MEc,1,189
1,693218,693260,trf,0,42
1,693227,693260,dust,0,33
1,693369,693422,L2c,1,53
1,693369,693422,L2c,1,53
1,694650,694809,MIRb,-1,159
1,694650,694809,MIRb,-1,159
1,695614,695661,AT_rich,1,47
1,695833,695878,dust,0,45
1,695844,696264,L1M7,1,420
1,695844,696264,L1M7,1,420
1,696277,696291,dust,0,14
1,696290,696330,L1M7,1,40
1,696290,696330,L1M7,1,40
1,696331,696475,FLAM_C,1,144
1,696331,696475,FLAM_C,1,144
1,696457,696490,dust,0,33
1,696476,696692,L1M7,1,216
1,696476,696692,L1M7,1,216
1,696722,696774,dust,0,52
1,697012,697705,L2c,-1,693
1,697012,697705,L2c,-1,693
1,697720,697986,L2b,1,266
1,697720,697986,L2b,1,266
1,698203,698441,MLT1H1,1,238
1,698203,698441,MLT1H1,1,238
1,698442,698799,THE1B,-1,357
1,698442,698799,THE1B,-1,357
1,698800,700363,THE1B-int,-1,1563
1,698800,700363,THE1B-int,-1,1563
1,700364,700723,THE1B,-1,359
1,700364,700723,THE1B,-1,359
1,700724,701000,MLT1H1,1,276
1,700724,701000,MLT1H1,1,276
1,700956,700963,dust,0,7
1,701001,701162,MLT1H1-int,1,161
1,701001,701162,MLT1H1-int,1,161
1,701148,701399,MLT1H1-int,1,251
1,701148,701399,MLT1H1-int,1,251
1,701404,701564,LTR64,-1,160
1,701404,701564,LTR64,-1,160
1,701567,701928,L1PA14,1,361
1,701567,701928,L1PA14,1,361
1,701901,701939,dust,0,38
1,702064,702369,AluSq2,1,305
1,702064,702369,AluSq2,1,305
1,702350,702369,dust,0,19
1,702423,702473,trf,0,50
1,702869,702938,L2a,1,69
1,702869,702938,L2a,1,69
1,703030,703567,L2b,1,537
1,703030,703567,L2b,1,537
1,703700,703832,MIRc,1,132
1,703700,703832,MIRc,1,132
1,704369,704432,L2a,-1,63
1,704369,704432,L2a,-1,63
1,704677,705086,MLT1F2,1,409
1,704677,705086,MLT1F2,1,409
1,704846,704889,dust,0,43
1,705174,705502,L1ME3E,1,328
1,705174,705502,L1ME3E,1,328
1,705220,705244,dust,0,24
1,705454,705461,dust,0,7
1,705530,705555,dust,0,25
1,706041,706177,LTR33B,1,136
1,706041,706177,LTR33B,1,136
1,706326,706428,L2,-1,102
1,706326,706428,L2,-1,102
1,706560,706697,MER65D,1,137
1,706560,706697,MER65D,1,137
1,706774,707054,MER65D,1,280
1,706774,707054,MER65D,1,280
1,707077,707193,L1M5,-1,116
1,707077,707193,L1M5,-1,116
1,707358,708016,L2a,1,658
1,707358,708016,L2a,1,658
1,708017,708213,L1ME3E,1,196
1,708017,708213,L1ME3E,1,196
1,708207,708593,L1ME3E,1,386
1,708207,708593,L1ME3E,1,386
1,708596,709085,MLT1D,1,489
1,708596,709085,MLT1D,1,489
1,709086,710125,L1ME3E,1,1039
1,709086,710125,L1ME3E,1,1039
1,709801,709853,dust,0,52
1,710219,710267,AT_rich,1,48
1,710257,710317,dust,0,60
1,710423,710468,dust,0,45
1,710424,710468,AT_rich,1,44
1,710516,710568,dust,0,52
1,710553,710933,THE1C,-1,380
1,710553,710933,THE1C,-1,380
1,711334,711341,dust,0,7
1,711497,711507,dust,0,10
1,711958,712094,dust,0,136
1,711958,712094,trf,0,136
1,711959,712094,trf,0,135
1,711959,712094,trf,0,135
1,711959,712094,(TA)n,1,135
1,712229,712524,AluY,-1,295
1,712229,712243,dust,0,14
1,712229,712524,AluY,-1,295
1,712571,712696,dust,0,125
1,712597,712670,AT_rich,1,73
1,713991,714088,(TA)n,1,97
1,714032,714088,dust,0,56
1,714046,714088,trf,0,42
1,714128,714224,L1MA5,1,96
1,714128,714224,L1MA5,1,96
1,714325,714426,trf,0,101
1,714405,714452,trf,0,47
1,714639,714709,L2a,1,70
1,714639,714709,L2a,1,70
1,714716,714828,L2a,1,112
1,714716,714828,L2a,1,112
1,714840,715390,L2c,1,550
1,714840,715390,L2c,1,550
1,715554,715848,AluJb,1,294
1,715554,715848,AluJb,1,294
1,715832,715848,dust,0,16
1,716590,716643,dust,0,53
1,716937,716964,AT_rich,1,27
1,716995,717045,dust,0,50
1,716995,717036,AT_rich,1,41
1,717037,717213,L1MA5,1,176
1,717037,717213,L1MA5,1,176
1,717200,717218,dust,0,18
1,717216,717984,L1M4c,1,768
1,717216,717984,L1M4c,1,768
1,717432,717440,dust,0,8
1,717931,717983,dust,0,52
1,718112,718149,AT_rich,1,37
1,718115,718122,dust,0,7
1,718525,718634,L2a,-1,109
1,718525,718634,L2a,-1,109
1,718759,719028,AluSz,-1,269
1,718759,719028,AluSz,-1,269
1,719465,719572,L2a,-1,107
1,719465,719572,L2a,-1,107
1,719573,719870,AluSq2,-1,297
1,719573,719588,dust,0,15
1,719573,719870,AluSq2,-1,297
1,719871,719996,L2a,-1,125
1,719871,719996,L2a,-1,125
1,720360,720652,AluSx,-1,292
1,720360,720386,dust,0,26
1,720360,720652,AluSx,-1,292
1,720506,720545,trf,0,39
1,720655,720670,dust,0,15
1,720656,720764,FLAM_C,-1,108
1,720656,720764,FLAM_C,-1,108
1,720767,720869,AluJo,1,102
1,720767,720869,AluJo,1,102
1,720885,720976,L1M2c,1,91
1,720885,720976,L1M2c,1,91
1,720946,720976,dust,0,30
1,720977,721291,AluSg,1,314
1,720977,721291,AluSg,1,314
1,721263,721278,dust,0,15
1,721292,721518,L1M2c,1,226
1,721292,721518,L1M2c,1,226
1,721516,721730,L1M2,1,214
1,721516,721730,L1M2,1,214
1,721731,721954,AluSq2,1,223
1,721731,721954,AluSq2,1,223
1,721934,721970,dust,0,36
1,721934,721970,trf,0,36
1,721943,721970,trf,0,27
1,721944,721970,trf,0,26
1,721955,721978,L1M2,1,23
1,721955,721978,L1M2,1,23
1,725052,725360,AluSg,-1,308
1,725052,725080,dust,0,28
1,725052,725080,trf,0,28
1,725052,725360,AluSg,-1,308
1,725824,725851,dust,0,27
1,727186,727394,trf,0,208
1,727186,727396,trf,0,210
1,727504,727573,trf,0,69
1,728367,728459,trf,0,92
1,728930,729046,trf,0,116
1,728930,729074,trf,0,144
1,729486,729565,trf,0,79
1,729816,730235,MER1A,-1,419
1,729816,730235,MER1A,-1,419
1,730502,730654,LTR41,-1,152
1,730502,730654,LTR41,-1,152
1,730658,730941,AluJr,1,283
1,730658,730941,AluJr,1,283
1,731001,731166,L1ME4c,1,165
1,731001,731166,L1ME4c,1,165
1,731169,731315,FLAM_C,-1,146
1,731169,731315,FLAM_C,-1,146
1,731535,731834,AluJr,-1,299
1,731535,731834,AluJr,-1,299
1,731946,732047,MER8,-1,101
1,731946,732047,MER8,-1,101
1,732048,732235,AluJb,1,187
1,732048,732235,AluJb,1,187
1,732217,732235,dust,0,18
1,732836,732969,AluJr,1,133
1,732836,732969,AluJr,1,133
1,733225,733644,MER1A,-1,419
1,733225,733644,MER1A,-1,419
1,733910,734062,LTR41,-1,152
1,733910,734062,LTR41,-1,152
1,734066,734358,AluJr,1,292
1,734066,734358,AluJr,1,292
1,734409,734565,L1ME4c,1,156
1,734409,734565,L1ME4c,1,156
1,734566,734706,AluJb,-1,140
1,734566,734706,AluJb,-1,140
1,734943,735242,AluJr,-1,299
1,734943,735242,AluJr,-1,299
1,735352,735453,MER8,-1,101
1,735352,735453,MER8,-1,101
1,735454,735641,AluJb,1,187
1,735454,735641,AluJb,1,187
1,735623,735641,dust,0,18
1,736187,736196,dust,0,9
1,736220,736376,AluJr,1,156
1,736220,736376,AluJr,1,156
1,736631,737050,MER1A,-1,419
1,736631,737050,MER1A,-1,419
1,737317,737469,LTR41,-1,152
1,737317,737469,LTR41,-1,152
1,737473,737756,AluJr,1,283
1,737473,737756,AluJr,1,283
1,737816,737981,L1ME4c,1,165
1,737816,737981,L1ME4c,1,165
1,737984,738130,FLAM_C,-1,146
1,737984,738130,FLAM_C,-1,146
1,738352,738651,AluJr,-1,299
1,738352,738651,AluJr,-1,299
1,738763,738864,MER8,-1,101
1,738763,738864,MER8,-1,101
1,738865,739057,AluJb,1,192
1,738865,739057,AluJb,1,192
1,739034,739057,dust,0,23
1,739603,739612,dust,0,9
1,739636,739792,AluJr,1,156
1,739636,739792,AluJr,1,156
1,740047,740466,MER1A,-1,419
1,740047,740466,MER1A,-1,419
1,740752,740838,AluJo,1,86
1,740752,740838,AluJo,1,86
1,740839,741123,AluJo,1,284
1,740839,741123,AluJo,1,284
1,740905,740928,trf,0,23
1,741107,741123,dust,0,16
1,741124,741629,MER21C,1,505
1,741124,741629,MER21C,1,505
1,741630,741936,AluJb,-1,306
1,741630,741936,AluJb,-1,306
1,741634,741641,dust,0,7
1,741793,741818,dust,0,25
1,741937,742006,MER21C,1,69
1,741937,742006,MER21C,1,69
1,742007,742309,AluJr,1,302
1,742007,742309,AluJr,1,302
1,742310,742610,MER21C,1,300
1,742310,742610,MER21C,1,300
1,742647,742845,MIRb,1,198
1,742647,742845,MIRb,1,198
1,743105,743208,L2b,1,103
1,743105,743208,L2b,1,103
1,743409,743428,trf,0,19
1,743504,743611,AluJb,-1,107
1,743504,743611,AluJb,-1,107
1,743645,743769,AluJr,1,124
1,743645,743769,AluJr,1,124
1,743783,744214,MER1A,-1,431
1,743783,744214,MER1A,-1,431
1,744517,744579,LTR41,-1,62
1,744517,744579,LTR41,-1,62
1,744580,744864,AluJb,1,284
1,744580,744864,AluJb,1,284
1,744865,744912,LTR41,-1,47
1,744865,744912,LTR41,-1,47
1,744867,744883,dust,0,16
1,744913,745209,AluSp,1,296
1,744913,745209,AluSp,1,296
1,745195,745209,dust,0,14
1,745210,745295,LTR41,-1,85
1,745210,745295,LTR41,-1,85
1,745296,745603,AluJr,1,307
1,745296,745603,AluJr,1,307
1,745416,745423,dust,0,7
1,745583,745603,dust,0,20
1,745624,745775,L2b,1,151
1,745624,745775,L2b,1,151
1,745826,746193,L2b,1,367
1,745826,746193,L2b,1,367
1,746221,746313,L2b,1,92
1,746221,746313,L2b,1,92
1,746378,746536,MLT1D,1,158
1,746378,746536,MLT1D,1,158
1,746538,746831,AluJr,1,293
1,746538,746831,AluJr,1,293
1,747086,747357,AluJr,1,271
1,747086,747357,AluJr,1,271
1,747348,747357,dust,0,9
1,747366,747467,AluJb,-1,101
1,747368,747462,AluJr4,-1,94
1,747468,747772,AluSx,1,304
1,747468,747737,AluSx,1,269
1,747740,747791,dust,0,51
1,747740,747791,trf,0,51
1,747740,747784,trf,0,44
1,747740,747784,(CAA)n,1,44
1,747785,747844,AluJb,-1,59
1,747789,747844,AluJo,-1,55
1,747901,747910,dust,0,9
1,747904,747934,L1M4,1,30
1,747904,747934,L1MB8,1,30
1,747935,748226,AluJb,1,291
1,747935,748226,AluJb,1,291
1,748217,748226,dust,0,9
1,748227,748311,L1M4,1,84
1,748227,748311,L1MB8,1,84
1,748349,748462,AluJo,-1,113
1,748349,748462,FLAM_A,-1,113
1,748463,749079,L1MB8,1,616
1,748463,749079,L1MB8,1,616
1,748633,748652,trf,0,19
1,749101,749402,AluJr,1,301
1,749101,749402,AluJr,1,301
1,749406,749520,Tigger12,-1,114
1,749406,749520,Tigger12,-1,114
1,749705,750012,AluSq2,1,307
1,749705,750012,AluSq2,1,307
1,749989,750008,dust,0,19
1,749992,750012,trf,0,20
1,750224,750317,LTR37A,-1,93
1,750224,750317,LTR37A,-1,93
1,750463,750758,AluJo,-1,295
1,750463,750758,AluJo,-1,295
1,750626,750639,dust,0,13
1,750759,750785,AT_rich,1,26
1,750761,750799,dust,0,38
1,750787,750918,AluJr,-1,131
1,750787,750918,AluJr,-1,131
1,751018,751625,L2a,1,607
1,751018,751625,L2a,1,607
1,751627,751789,AluJb,-1,162
1,751627,751789,AluJb,-1,162
1,751790,752075,AluSg7,-1,285
1,751790,751806,dust,0,16
1,751790,752075,AluSg7,-1,285
1,752076,752202,AluJb,-1,126
1,752076,752202,AluJb,-1,126
1,752086,752094,dust,0,8
1,752224,752580,MLT1D,-1,356
1,752224,752580,MLT1D,-1,356
1,752584,752875,AluJr,1,291
1,752584,752875,AluJr,1,291
1,752876,753134,MER21C,1,258
1,752876,753134,MER21C,1,258
1,753135,753428,AluSq2,-1,293
1,753135,753144,dust,0,9
1,753135,753428,AluSq2,-1,293
1,753429,753738,MER21C,1,309
1,753429,753738,MER21C,1,309
1,753739,754045,AluJo,1,306
1,753739,754045,AluJo,1,306
1,754026,754045,dust,0,19
1,754046,754345,MER21C,1,299
1,754046,754345,MER21C,1,299
1,754347,755409,MER11B,1,1062
1,754347,755409,MER11B,1,1062
1,755455,755649,MIRb,1,194
1,755455,755649,MIRb,1,194
1,755864,755927,(CACCC)n,1,63
1,755871,755924,dust,0,53
1,756165,756177,dust,0,12
1,756302,756323,dust,0,21
1,756303,756422,AluJb,-1,119
1,756303,756422,AluJb,-1,119
1,756425,756724,AluJo,-1,299
1,756425,756724,AluJo,-1,299
1,756588,756605,dust,0,17
1,756764,756904,L1ME4b,1,140
1,756764,756904,L1ME4b,1,140
1,757026,757064,AT_rich,1,38
1,757135,757444,AluJr,1,309
1,757135,757444,AluJr,1,309
1,757253,757271,dust,0,18
1,757415,757427,dust,0,12
1,757489,757782,AluSg,1,293
1,757489,757782,AluSg,1,293
1,757791,757944,L1ME4c,1,153
1,757791,757944,L1ME4c,1,153
1,757945,757952,dust,0,7
1,757948,758067,AluJr4,-1,119
1,757948,758067,AluJr4,-1,119
1,758068,758191,L1ME4c,1,123
1,758068,758191,L1ME4c,1,123
1,758214,758230,dust,0,16
1,758411,758451,MIRb,1,40
1,758411,758451,MIRb,1,40
1,758556,758663,MER8,-1,107
1,758556,758663,MER8,-1,107
1,758668,758819,AluJb,1,151
1,758668,758819,AluJb,1,151
1,759162,759445,AluJr,1,283
1,759162,759445,AluJr,1,283
1,759447,759498,dust,0,51
1,759447,759498,trf,0,51
1,759447,759498,(CA)n,1,51
1,759821,760044,AluSx1,1,223
1,759821,760044,AluSx1,1,223
1,760937,760951,dust,0,14
1,761764,762169,L1MC5a,1,405
1,761764,762169,L1MC5a,1,405
1,762032,762040,dust,0,8
1,762180,762271,L1MC5a,1,91
1,762180,762271,L1MC5a,1,91
1,762580,762645,MSTD,-1,65
1,762580,762645,MSTD,-1,65
1,762634,762859,dust,0,225
1,762637,762789,trf,0,152
1,762646,762815,GA-rich,1,169
1,762661,762809,trf,0,148
1,762663,762804,trf,0,141
1,762816,762852,G-rich,1,36
1,762854,763171,MSTD,-1,317
1,762854,763171,MSTD,-1,317
1,764275,764289,dust,0,14
1,764308,764613,AluSq2,1,305
1,764308,764588,AluSq2,1,280
1,764589,764613,dust,0,24
1,764590,764613,trf,0,23
1,764590,764613,(CAAAA)n,1,23
1,764819,765151,AluSq2,1,332
1,764819,765151,AluSq2,1,332
1,764864,764930,trf,0,66
1,765134,765151,dust,0,17
1,765463,765756,AluSx1,1,293
1,765463,765756,AluSx1,1,293
1,765744,765756,dust,0,12
1,766500,766778,AluSx1,1,278
1,766500,766778,AluSx1,1,278
1,766812,766945,MIRb,-1,133
1,766812,766945,MIRb,-1,133
1,767025,767043,dust,0,18
1,767578,767881,AluSp,-1,303
1,767579,767881,AluSp,-1,302
1,767943,768240,AluSg7,1,297
1,767943,768240,AluSg7,1,297
1,768222,768229,dust,0,7
1,768933,769234,AluSx1,1,301
1,768933,769234,AluSx1,1,301
1,769021,769054,dust,0,33
1,769215,769234,dust,0,19
1,769363,769790,MLT1D,1,427
1,769363,769790,MLT1D,1,427
1,769822,770127,AluSz,1,305
1,769822,770127,AluSz,1,305
1,770106,770127,dust,0,21
1,770305,770568,AluSg,-1,263
1,770305,770568,AluSg,-1,263
1,770308,770321,dust,0,13
1,770889,770896,dust,0,7
1,770951,770958,dust,0,7
1,771118,771181,dust,0,63
1,771354,771375,dust,0,21
1,771354,771373,trf,0,19
1,771354,771655,AluSq2,-1,301
1,771355,771655,AluSq2,-1,300
1,771802,771830,trf,0,28
1,772514,772531,dust,0,17
1,772515,772565,AluSq2,-1,50
1,772515,772565,AluSq2,-1,50
1,772826,772908,MIR1_Amn,-1,82
1,772826,772908,MIR1_Amn,-1,82
1,773083,773132,L2c,1,49
1,773083,773132,L2c,1,49
1,773252,773332,MIRb,-1,80
1,773252,773332,MIRb,-1,80
1,773543,773552,dust,0,9
1,774791,774926,AluSx,1,135
1,774791,775116,trf,0,325
1,774791,774926,AluSx,1,135
1,774927,775230,AluSp,1,303
1,774927,775230,AluSp,1,303
1,775209,775230,dust,0,21
1,775231,775329,AluSx,1,98
1,775231,775329,AluSx,1,98
1,775310,775325,dust,0,15
1,775323,775352,trf,0,29
1,775327,775352,dust,0,25
1,775560,775872,AluSx,1,312
1,775560,775872,AluSx,1,312
1,775841,775881,dust,0,40
1,775841,775881,trf,0,40
1,776001,776293,AluSp,-1,292
1,776001,776013,dust,0,12
1,776001,776293,AluSp,-1,292
1,776317,776633,AluSx1,1,316
1,776317,776648,AluSx,1,331
1,776603,776693,dust,0,90
1,776605,776633,trf,0,28
1,776763,776847,MIRb,-1,84
1,776763,776847,MIRb,-1,84
1,777390,777597,AluJo,-1,207
1,777390,777597,AluJo,-1,207
1,777600,777872,AluSx,-1,272
1,777600,777872,AluSx,-1,272
1,777910,778062,AluJo,1,152
1,777910,778062,AluJo,1,152
1,778063,778194,AluJo,-1,131
1,778063,778194,AluJo,-1,131
1,778255,778442,FRAM,-1,187
1,778255,778270,dust,0,15
1,778255,778442,FRAM,-1,187
1,779336,779630,AluSg7,1,294
1,779336,779630,AluSg7,1,294
1,779643,779739,trf,0,96
1,779683,779791,AluSx,1,108
1,779683,779791,AluSx,1,108
1,779851,780056,AluJb,1,205
1,779851,780056,AluJb,1,205
1,780059,780139,AluJo,-1,80
1,780059,780139,AluJo,-1,80
1,780238,780275,dust,0,37
1,780261,780575,AluJb,-1,314
1,780261,780575,AluJb,-1,314
1,780603,780625,dust,0,22
1,780617,780773,AluSc,-1,156
1,780617,780773,AluSc,-1,156
1,780774,780860,AluJb,1,86
1,780774,780860,AluJb,1,86
1,782312,782501,MER3,-1,189
1,782312,782501,MER3,-1,189
1,782347,782374,trf,0,27
1,782641,782795,MER5A1,-1,154
1,782641,782795,MER5A1,-1,154
1,782829,783115,MER33,1,286
1,782829,783115,MER33,1,286
1,783407,783420,dust,0,13
1,783621,783884,L1ME3,-1,263
1,783621,783884,L1ME3,-1,263
1,784072,784108,AT_rich,1,36
1,784084,784106,dust,0,22
1,784116,784356,L1MEg,1,240
1,784116,784356,L1MEg,1,240
1,784344,784744,L1MC4,1,400
1,784344,784744,L1MC4,1,400
1,784746,785369,L1MC4,1,623
1,784746,785369,L1MC4,1,623
1,785424,785494,L1MEg,1,70
1,785424,785494,L1MEg,1,70
1,785495,785733,L1PA4,1,238
1,785495,785733,L1PA4,1,238
1,785575,785596,dust,0,21
1,785725,785733,dust,0,8
1,785734,785761,L1MEg,1,27
1,785734,785761,L1MEg,1,27
1,785994,786249,LTR104_Mam,-1,255
1,785994,786249,LTR104_Mam,-1,255
1,786262,786313,BLACKJACK,1,51
1,786262,786313,BLACKJACK,1,51
1,786314,786376,L1M3,-1,62
1,786314,786376,L1M3,-1,62
1,786340,786389,dust,0,49
1,786377,786507,AluJr,-1,130
1,786377,786507,AluJr,-1,130
1,786508,787339,L1M3,-1,831
1,786508,786984,L1M3,-1,476
1,786966,787006,dust,0,40
1,786985,787004,trf,0,19
1,786985,787004,(TTTA)n,1,19
1,787005,787339,L1M3,-1,334
1,787352,787718,LTR7,1,366
1,787352,787718,LTR7,1,366
1,787729,787833,MIRc,-1,104
1,787729,787833,MIRc,-1,104
1,788085,788363,AluSp,1,278
1,788085,788363,AluSp,1,278
1,788365,788435,trf,0,70
1,788365,788438,GA-rich,1,73
1,788369,788435,dust,0,66
1,788635,788750,MER67C,-1,115
1,788635,788750,MER67C,-1,115
1,788758,788929,dust,0,171
1,788758,791673,trf,0,2915
1,788758,791673,trf,0,2915
1,788758,791673,trf,0,2915
1,788758,789293,(GAATG)n,1,535
1,788932,788995,dust,0,63
1,789060,789313,dust,0,253
1,789307,789486,(GAATG)n,1,179
1,789444,789664,dust,0,220
1,789518,790510,(GAATG)n,1,992
1,789668,789981,dust,0,313
1,790021,790883,dust,0,862
1,790527,790706,(GAATG)n,1,179
1,790734,791646,(GAATG)n,1,912
1,790918,791138,dust,0,220
1,791053,791098,trf,0,45
1,791172,791299,dust,0,127
1,791305,791395,dust,0,90
1,791428,791488,dust,0,60
1,791492,791646,dust,0,154
1,791822,791993,LTR67B,-1,171
1,791822,791993,LTR67B,-1,171
1,792384,793725,L1M7,-1,1341
1,792384,793725,L1M7,-1,1341
1,792388,792443,dust,0,55
1,793726,794040,Tigger4b,1,314
1,793726,794040,Tigger4b,1,314
1,794041,794177,L1M7,-1,136
1,794041,794177,L1M7,-1,136
1,794556,794727,L1M7,-1,171
1,794556,794727,L1M7,-1,171
1,794994,795251,LTR79,-1,257
1,794994,795251,LTR79,-1,257
1,795362,795592,Charlie1b,1,230
1,795362,795609,Charlie1b,1,247
1,795607,795932,AluSq2,-1,325
1,795607,795628,dust,0,21
1,795610,795630,trf,0,20
1,795610,795932,AluSq2,-1,322
1,795769,795809,trf,0,40
1,795933,796100,Charlie1b,1,167
1,795939,796100,Charlie1a,1,161
1,796539,796837,Tigger3a,-1,298
1,796539,796837,Tigger3a,-1,298
1,796916,797131,L1M5,1,215
1,796916,797131,L1M5,1,215
1,797344,797557,MIR,-1,213
1,797344,797557,MIR,-1,213
1,798734,799039,AluSx1,1,305
1,798734,799039,AluSx1,1,305
1,799016,799039,dust,0,23
1,799083,799096,dust,0,13
1,799201,799211,dust,0,10
1,799270,799325,L2c,-1,55
1,799270,799325,L2c,-1,55
1,799502,800409,L1PA7,-1,907
1,799502,800409,L1PA7,-1,907
1,800410,800908,L1PA7,1,498
1,800410,800908,L1PA7,1,498
1,800749,800761,dust,0,12
1,801204,801381,MIR,-1,177
1,801204,801381,MIR,-1,177
1,801519,801536,dust,0,17
1,801589,801715,AluJo,-1,126
1,801589,801715,AluJo,-1,126
1,802512,802604,L2a,-1,92
1,802512,802604,L2a,-1,92
1,803150,803446,AluSz,1,296
1,803150,803446,AluSz,1,296
1,803435,803446,dust,0,11
1,803751,803761,dust,0,10
1,804219,804482,MER113A,1,263
1,804219,804482,MER113A,1,263
1,804433,804442,dust,0,9
1,807025,807086,L2a,-1,61
1,807025,807086,L2a,-1,61
1,807402,807502,MLT1O,1,100
1,807402,807502,MLT1O,1,100
1,808205,808256,dust,0,51
1,808269,808341,trf,0,72
1,808269,808338,(CATA)n,1,69
1,808274,808393,dust,0,119
1,808274,808320,trf,0,46
1,808290,808338,trf,0,48
1,808296,808338,trf,0,42
1,809061,809590,MER44B,1,529
1,809061,809590,MER44B,1,529
1,809501,809509,dust,0,8
1,810099,810112,dust,0,13
1,810827,810836,dust,0,9
1,812029,812068,trf,0,39
1,812115,813014,L1MB3,1,899
1,812115,813014,L1MB3,1,899
1,812312,812324,dust,0,12
1,813743,813829,Chap1_Mam,1,86
1,813743,813829,Chap1_Mam,1,86
1,813876,814012,MLT1C,1,136
1,813876,814012,MLT1C,1,136
1,814584,814591,dust,0,7
1,815155,815497,L1M8,1,342
1,815155,815497,L1M8,1,342
1,815624,815669,dust,0,45
1,815700,815811,L1M8,1,111
1,815700,815811,L1M8,1,111
1,815868,816055,L1M5,1,187
1,815868,816055,L1M5,1,187
1,815898,815959,dust,0,61
1,816109,816121,dust,0,12
1,816171,816234,HAL1M8,1,63
1,816171,816234,HAL1M8,1,63
1,816228,816461,L1ME3B,1,233
1,816228,816461,L1ME3B,1,233
1,816539,816563,AT_rich,1,24
1,816629,817288,L1P4,1,659
1,816629,817288,L1P4,1,659
1,818040,818201,MER58A,-1,161
1,818040,818201,MER58A,-1,161
1,818622,818794,MER102c,1,172
1,818622,818794,MER102c,1,172
1,819066,819303,MLT1I,1,237
1,819066,819303,MLT1I,1,237
1,819610,819650,L2c,-1,40
1,819610,819650,L2c,-1,40
1,819731,819948,MER44D,1,217
1,819731,819948,MER44D,1,217
1,819914,823663,trf,0,3749
1,824042,824073,AT_rich,1,31
1,824328,824348,AT_rich,1,20
1,824409,824417,dust,0,8
1,827563,827629,G-rich,1,66
1,827583,827629,dust,0,46
1,827584,827610,trf,0,26
1,828211,828265,dust,0,54
1,828228,828263,(TA)n,1,35
1,828390,828400,dust,0,10
1,828713,828809,L1MC,-1,96
1,828713,828809,L1MC,-1,96
1,828812,828986,MER41D,-1,174
1,828812,828986,MER41D,-1,174
1,828987,829262,AluSq2,-1,275
1,828987,828995,dust,0,8
1,828987,829262,AluSq2,-1,275
1,829263,829390,MER41D,-1,127
1,829263,829390,MER41D,-1,127
1,829438,829595,trf,0,157
1,829596,830064,HAL1,-1,468
1,829596,830064,HAL1,-1,468
1,830065,830433,MLT1A1,1,368
1,830065,830433,MLT1A1,1,368
1,830434,830847,HAL1,-1,413
1,830434,830847,HAL1,-1,413
1,830887,831024,HAL1,-1,137
1,830887,831024,HAL1,-1,137
1,831109,831353,LTR78,-1,244
1,831109,831353,LTR78,-1,244
1,832523,832607,dust,0,84
1,832523,832606,CT-rich,1,83
1,832658,832711,trf,0,53
1,832737,832781,dust,0,44
1,832737,832781,trf,0,44
1,832737,833054,AluSx,-1,317
1,832753,833054,AluSx,-1,301
1,833607,833708,MIR3,-1,101
1,833607,833708,MIR3,-1,101
1,834761,834905,MLT1K,-1,144
1,834761,834905,MLT1K,-1,144
1,834912,834973,trf,0,61
1,834912,834981,(TCCA)n,1,69
1,834913,834973,dust,0,60
1,835041,835165,dust,0,124
1,835068,835180,(TCCA)n,1,112
1,835627,835728,L2c,-1,101
1,835627,835728,L2c,-1,101
1,836042,836120,MIR3,1,78
1,836042,836120,MIR3,1,78
1,836348,836399,L2b,1,51
1,836348,836399,L2b,1,51
1,836414,836851,LTR16C,1,437
1,836414,836851,LTR16C,1,437
1,836853,836925,L2b,1,72
1,836853,836925,L2b,1,72
1,837024,837170,AluJb,-1,146
1,837024,837170,AluJb,-1,146
1,837030,837038,dust,0,8
1,837099,837180,SVA_D,1,81
1,837099,837180,SVA_D,1,81
1,837340,837504,MER58A,-1,164
1,837340,837504,MER58A,-1,164
1,837512,840216,L1M4b,1,2704
1,837512,840216,L1M4b,1,2704
1,838927,838962,dust,0,35
1,839178,839215,trf,0,37
1,839178,839215,trf,0,37
1,839288,839650,dust,0,362
1,839299,839650,trf,0,351
1,840199,840402,L1MB8,1,203
1,840199,840402,L1MB8,1,203
1,840410,840424,dust,0,14
1,840410,840442,trf,0,32
1,840410,840440,(A)n,1,30
1,840501,840618,MIRb,-1,117
1,840501,840618,MIRb,-1,117
1,841508,841658,MER5A1,1,150
1,841508,841658,MER5A1,1,150
1,841663,841828,MIRb,1,165
1,841663,841828,MIRb,1,165
1,841914,841941,trf,0,27
1,843987,844346,MLT1B,1,359
1,843987,844346,MLT1B,1,359
1,844361,844403,trf,0,42
1,844527,844542,dust,0,15
1,844931,844989,Charlie5,1,58
1,844931,844989,Charlie5,1,58
1,845970,846625,L1MC1,1,655
1,845970,846625,L1MC1,1,655
1,846972,847188,MER103C,1,216
1,846972,847188,MER103C,1,216
1,847809,847932,MIR,-1,123
1,847809,847932,MIR,-1,123
1,849557,849911,MSTD,-1,354
1,849557,849911,MSTD,-1,354
1,850631,850640,dust,0,9
1,850646,851208,L1PA3,-1,562
1,850646,851208,L1PA3,-1,562
1,850786,850808,dust,0,22
1,852490,852526,dust,0,36
1,852835,852959,FLAM_A,-1,124
1,852835,852959,FLAM_A,-1,124
1,852971,853263,AluSz,-1,292
1,852971,852979,dust,0,8
1,852971,853263,AluSz,-1,292
1,853264,853435,Charlie19a,-1,171
1,853264,853435,Charlie19a,-1,171
1,853416,853906,trf,0,490
1,855211,855355,(TATG)n,1,144
1,855368,855505,dust,0,137
1,855375,855562,(TG)n,1,187
1,857949,857959,dust,0,10
1,858970,859039,L3,-1,69
1,858970,859039,L3,-1,69
1,859139,859187,dust,0,48
1,859352,859744,L1ME4a,-1,392
1,859352,859744,L1ME4a,-1,392
1,860179,860211,dust,0,32
1,860179,860211,trf,0,32
1,860182,860497,AluJr,-1,315
1,860182,860497,AluJr,-1,315
1,860788,860972,LTR2C,-1,184
1,860788,860972,LTR2C,-1,184
1,861617,861678,dust,0,61
1,861617,861735,(TATATG)n,1,118
1,861689,862150,(TAGA)n,1,461
1,861775,862185,dust,0,410
1,862755,863199,MLT1K,-1,444
1,862755,863199,MLT1K,-1,444
1,863516,863653,L2b,-1,137
1,863516,863653,L2b,-1,137
1,865563,865716,MIRc,1,153
1,865563,865716,MIRc,1,153
1,866279,866448,MLT1B,-1,169
1,866279,866448,MLT1B,-1,169
1,866415,867192,trf,0,777
1,868207,868266,dust,0,59
1,868243,868271,AT_rich,1,28
1,869214,869225,dust,0,11
1,869216,869299,A-rich,1,83
1,869237,869281,dust,0,44
1,869454,869520,trf,0,66
1,869454,869520,trf,0,66
1,869454,869520,(TCTA)n,1,66
1,869462,869520,dust,0,58
1,869463,869504,trf,0,41
1,869464,869520,trf,0,56
1,869589,869610,AT_rich,1,21
1,869599,869609,dust,0,10
1,869625,869730,MIRb,-1,105
1,869625,869730,MIRb,-1,105
1,869718,869760,trf,0,42
1,870168,870208,trf,0,40
1,870687,870752,trf,0,65
1,871048,871260,L1M4,-1,212
1,871048,871260,L1M4,-1,212
1,871261,871425,FRAM,-1,164
1,871261,871425,FRAM,-1,164
1,871426,871792,L1M4,-1,366
1,871426,871792,L1M4,-1,366
1,871923,871938,dust,0,15
1,872504,873179,trf,0,675
1,872504,873179,trf,0,675
1,875829,876433,dust,0,604
1,875830,876438,trf,0,608
1,875847,876019,C-rich,1,172
1,875934,876108,(CACCC)n,1,174
1,876162,876341,C-rich,1,179
1,876261,876434,(CACCC)n,1,173
1,879078,879247,L1MB4,-1,169
1,879078,879247,L1MB4,-1,169
1,879252,879387,L1M5,1,135
1,879252,879387,L1M5,1,135
1,879380,879422,dust,0,42
1,879418,881416,L1M3,-1,1998
1,879418,881416,L1M3,-1,1998
1,879684,879744,dust,0,60
1,880274,880351,dust,0,77
1,880874,880928,dust,0,54
1,881946,881953,dust,0,7
1,882685,882948,L1PA7,-1,263
1,882685,882948,L1PA7,-1,263
1,882935,882978,dust,0,43
1,882949,883243,AluSp,-1,294
1,882949,883243,AluSp,-1,294
1,883244,885344,L1PA7,-1,2100
1,883244,885344,L1PA7,-1,2100
1,885341,887183,L1PA7,-1,1842
1,885341,887183,L1PA7,-1,1842
1,885385,885445,dust,0,60
1,885889,885940,dust,0,51
1,887051,887070,trf,0,19
1,887236,887272,trf,0,36
1,887427,887910,L1ME4b,1,483
1,887427,887910,L1ME4b,1,483
1,888098,888264,L1M5,-1,166
1,888098,888264,L1M5,-1,166
1,888310,888345,GA-rich,1,35
1,888321,888697,dust,0,376
1,888348,888528,A-rich,1,180
1,888512,888679,G-rich,1,167
1,888538,888673,trf,0,135
1,888599,888679,trf,0,80
1,888599,888693,trf,0,94
1,888957,889347,MSTD,1,390
1,888957,889347,MSTD,1,390
1,889627,889732,BSR/Beta,1,105
1,889627,889732,BSR/Beta,1,105
1,889767,889923,MIRb,1,156
1,889767,889923,MIRb,1,156
1,889928,889998,MLT1I,-1,70
1,889928,889998,MLT1I,-1,70
1,889997,890025,dust,0,28
1,889999,890324,AluSc8,-1,325
1,889999,890324,AluSc8,-1,325
1,890325,890375,MLT1I,-1,50
1,890325,890375,MLT1I,-1,50
1,890387,890457,AluYj4,1,70
1,890387,890457,AluYj4,1,70
1,890447,890457,dust,0,10
1,890614,890679,LTR41,1,65
1,890614,890679,LTR41,1,65
1,890935,891105,LOR1-int,-1,170
1,890935,891105,LOR1-int,-1,170
1,891269,891499,LOR1-int,-1,230
1,891269,891499,LOR1-int,-1,230
1,891511,891802,LOR1-int,-1,291
1,891511,891802,LOR1-int,-1,291
1,891803,892094,AluSq2,-1,291
1,891803,891811,dust,0,8
1,891803,892094,AluSq2,-1,291
1,892095,892183,LOR1-int,-1,88
1,892095,892183,LOR1-int,-1,88
1,892184,892456,AluJr,1,272
1,892184,892456,AluJr,1,272
1,892287,892300,dust,0,13
1,892457,892928,LOR1-int,-1,471
1,892457,892928,LOR1-int,-1,471
1,892733,892753,dust,0,20
1,892939,893255,AluJo,1,316
1,892939,893255,AluJo,1,316
1,893283,893495,LTR57-int,-1,212
1,893283,893302,LTR57-int,-1,19
1,893303,893495,LOR1-int,-1,192
1,893370,893378,dust,0,8
1,893496,893802,AluSz6,1,306
1,893496,893801,AluSz6,1,305
1,893777,893840,dust,0,63
1,893777,893802,trf,0,25
1,893802,893840,trf,0,38
1,893802,893840,(TA)n,1,38
1,893848,894130,AluSz,1,282
1,893848,894130,AluSz,1,282
1,894131,894144,dust,0,13
1,894131,894203,LOR1-int,-1,72
1,894141,894200,LTR57-int,-1,59
1,894361,894466,LTR49-int,-1,105
1,894361,894466,LTR49-int,-1,105
1,894862,895173,AluSp,-1,311
1,894862,894891,dust,0,29
1,894862,895173,AluSp,-1,311
1,895290,895508,AluYf1,-1,218
1,895290,895508,AluYf1,-1,218
1,895510,895548,HERVK9-int,1,38
1,895510,895548,HERVK9-int,1,38
1,895544,895868,HERVK9-int,-1,324
1,895544,895868,HERVK9-int,-1,324
1,895870,896099,HERVK9-int,-1,229
1,895870,896099,HERVK9-int,-1,229
1,896100,897617,HERVK9-int,-1,1517
1,896100,897617,HERVK9-int,-1,1517
1,897581,897602,dust,0,21
1,897610,898198,HERVK9-int,-1,588
1,897610,898198,HERVK9-int,-1,588
1,898199,898699,MER9a2,-1,500
1,898199,898699,MER9a2,-1,500
1,898641,898675,trf,0,34
1,898642,898679,trf,0,37
1,899022,899326,AluY,-1,304
1,899022,899326,AluY,-1,304
1,899025,899045,dust,0,20
1,899025,899045,trf,0,20
1,899671,899729,MER102a,1,58
1,899671,899729,MER102a,1,58
1,900211,900937,L1MC3,1,726
1,900211,900937,L1MC3,1,726
1,900349,900412,trf,0,63
1,900517,900524,dust,0,7
1,900942,901241,AluJb,1,299
1,900942,901241,AluJb,1,299
1,901226,901239,dust,0,13
1,901363,901555,MER67A,-1,192
1,901363,901555,MER67A,-1,192
1,901672,901800,L2c,-1,128
1,901672,901800,L2c,-1,128
1,902502,902788,AluSq2,1,286
1,902502,902788,AluSq2,1,286
1,902774,902788,dust,0,14
1,902970,903274,MLT1B,-1,304
1,902970,903274,MLT1B,-1,304
1,903382,903639,MLT1A,1,257
1,903382,903639,MLT1A,1,257
1,903640,903726,MER2,-1,86
1,903640,903726,MER2,-1,86
1,904297,904314,dust,0,17
1,904413,904435,GC_rich,1,22
1,904472,904739,trf,0,267
1,904472,904743,trf,0,271
1,904475,904683,trf,0,208
1,904502,904690,dust,0,188
1,904540,904744,trf,0,204
1,904627,904809,(CCG)n,1,182
1,904685,904718,trf,0,33
1,904950,905006,dust,0,56
1,904971,905006,trf,0,35
1,905013,905114,trf,0,101
1,905266,905461,L1MB5,1,195
1,905266,905461,L1MB5,1,195
1,905569,905799,L1MB5,1,230
1,905569,905799,L1MB5,1,230
1,906474,906556,HERV16-int,-1,82
1,906474,906556,HERV16-int,-1,82
1,906875,907014,trf,0,139
1,907171,907250,AluSz6,1,79
1,907171,907250,AluSz6,1,79
1,907237,907250,dust,0,13
1,907253,907562,AluSz,1,309
1,907253,907562,AluSz,1,309
1,907539,907562,dust,0,23
1,907539,907562,trf,0,23
1,908056,908165,L2a,1,109
1,908056,908165,L2a,1,109
1,908461,908852,dust,0,391
1,908462,908539,trf,0,77
1,908533,908712,G-rich,1,179
1,908534,908797,trf,0,263
1,908587,908822,trf,0,235
1,908643,908822,trf,0,179
1,908728,908812,trf,0,84
1,908728,908851,G-rich,1,123
1,908766,908849,trf,0,83
1,908921,909899,trf,0,978
1,908921,909899,trf,0,978
1,908921,909899,trf,0,978
1,909951,910000,GC_rich,1,49
1,910110,910185,dust,0,75
1,910310,910344,GC_rich,1,34
1,911852,911997,MIRb,-1,145
1,911852,911997,MIRb,-1,145
1,912320,912400,MIRb,1,80
1,912320,912400,MIRb,1,80
1,912463,912649,L2b,-1,186
1,912463,912649,L2b,-1,186
1,912842,912915,L2b,1,73
1,912842,912915,L2b,1,73
1,914456,914665,L1MEc,1,209
1,914456,914665,L1MEc,1,209
1,914666,914977,AluSp,1,311
1,914666,914977,AluSp,1,311
1,914784,914791,dust,0,7
1,914949,914989,dust,0,40
1,914951,914990,trf,0,39
1,914952,914989,trf,0,37
1,914978,915397,L1MEc,1,419
1,914978,915397,L1MEc,1,419
1,915597,915677,trf,0,80
1,915717,915837,MIRc,-1,120
1,915717,915837,MIRc,-1,120
1,916351,916432,trf,0,81
1,919107,919193,L2c,-1,86
1,919107,919193,L2c,-1,86
1,921583,921640,trf,0,57
1,921681,921725,trf,0,44
1,923333,923423,MIR,1,90
1,923333,923423,MIR,1,90
1,923821,923883,dust,0,62
1,923852,923891,GC_rich,1,39
1,923943,923964,GC_rich,1,21
1,923949,924037,dust,0,88
1,923988,924013,GC_rich,1,25
1,924102,924136,GC_rich,1,34
1,924232,924308,GC_rich,1,76
1,924237,924332,dust,0,95
1,924507,924603,(CCG)n,1,96
1,924620,924647,GC_rich,1,27
1,925325,925388,dust,0,63
1,925328,925390,GC_rich,1,62
1,928112,928412,AluY,1,300
1,928112,928412,AluY,1,300
1,928392,928405,dust,0,13
1,930078,930152,trf,0,74
1,930083,930152,CT-rich,1,69
1,930093,930149,dust,0,56
1,933005,933067,dust,0,62
1,933011,933083,C-rich,1,72
1,933742,933749,dust,0,7
1,933962,934962,trf,0,1000
1,934341,934436,dust,0,95
1,934512,934519,dust,0,7
1,934596,934631,dust,0,35
1,934932,934939,dust,0,7
1,935305,935345,MIR3,1,40
1,935305,935345,MIR3,1,40
1,936235,936468,trf,0,233
1,937397,937407,dust,0,10
1,937696,937718,GC_rich,1,22
1,938218,938329,trf,0,111
1,938218,938345,trf,0,127
1,939399,939508,trf,0,109
1,940235,940267,GC_rich,1,32
1,940284,940329,GC_rich,1,45
1,940297,940313,dust,0,16
1,941882,941902,GC_rich,1,20
1,941911,941960,dust,0,49
1,941970,941991,GC_rich,1,21
1,942037,942107,dust,0,70
1,942502,942526,GC_rich,1,24
1,942720,942767,dust,0,47
1,943527,943548,dust,0,21
1,943527,943548,trf,0,21
1,943527,943548,(T)n,1,21
1,944507,944526,trf,0,19
1,944507,944526,(CAGCC)n,1,19
1,945074,945117,CT-rich,1,43
1,946777,947062,AluSx1,1,285
1,946777,947062,AluSx1,1,285
1,947655,947744,trf,0,89
1,948642,948729,trf,0,87
1,948647,948677,trf,0,30
1,950073,950166,(CA)n,1,93
1,950075,950187,dust,0,112
1,950097,950165,trf,0,68
1,950168,950381,(CA)n,1,213
1,950202,950232,trf,0,30
1,950288,950381,dust,0,93
1,950307,950349,trf,0,42
1,950321,950445,trf,0,124
1,950389,950477,dust,0,88
1,950406,950783,(CA)n,1,377
1,950510,950603,dust,0,93
1,950519,950550,trf,0,31
1,950521,950548,trf,0,27
1,950614,950669,dust,0,55
1,951960,951995,trf,0,35
1,954548,954845,AluJo,1,297
1,954548,954845,AluJo,1,297
1,954828,954874,dust,0,46
1,954831,954876,trf,0,45
1,954843,954873,trf,0,30
1,954852,954876,(CAAAA)n,1,24
1,955874,955917,dust,0,43
1,956297,956316,trf,0,19
1,956763,956895,trf,0,132
1,957459,957573,trf,0,114
1,957535,958046,L2a,1,511
1,957535,958046,L2a,1,511
1,958062,958243,AluSx,-1,181
1,958062,958081,dust,0,19
1,958062,958081,trf,0,19
1,958062,958243,AluSx,-1,181
1,958235,958270,dust,0,35
1,958244,958549,AluSx,-1,305
1,958244,958549,AluSx,-1,305
1,958551,958795,L2a,1,244
1,958551,958795,L2a,1,244
1,959302,959353,dust,0,51
1,959305,959352,(CCCCG)n,1,47
1,960069,960183,dust,0,114
1,960091,960472,trf,0,381
1,960091,960472,trf,0,381
1,960091,960470,trf,0,379
1,960278,960345,dust,0,67
1,960278,960297,trf,0,19
1,960278,960297,(GGA)n,1,19
1,960732,960766,trf,0,34
1,960749,960859,GC_rich,1,110
1,960807,960833,dust,0,26
1,960807,960833,trf,0,26
1,961206,961254,GC_rich,1,48
1,962074,962095,dust,0,21
1,962076,962095,trf,0,19
1,962076,962095,(CACCC)n,1,19
1,964543,964844,trf,0,301
1,964615,964742,dust,0,127
1,964775,964836,dust,0,61
1,965303,965346,dust,0,43
1,965304,965346,trf,0,42
1,965304,965344,trf,0,40
1,965304,965346,(TTTA)n,1,42
1,967029,967054,GC_rich,1,25
1,967365,967386,dust,0,21
1,968520,968877,L2a,-1,357
1,968520,968877,L2a,-1,357
1,968882,968909,trf,0,27
1,968997,969136,MER63B,1,139
1,968997,969136,MER63B,1,139
1,969303,969395,dust,0,92
1,969315,969383,(TG)n,1,68
1,969334,969385,trf,0,51
1,969408,969586,dust,0,178
1,969409,969586,(TG)n,1,177
1,969453,969557,trf,0,104
1,969463,969574,trf,0,111
1,969470,969521,trf,0,51
1,969588,969809,dust,0,221
1,969589,969629,(TATG)n,1,40
1,969635,969809,(TG)n,1,174
1,969722,969765,trf,0,43
1,969768,969818,trf,0,50
1,969811,969913,(CATG)n,1,102
1,969959,970182,trf,0,223
1,971670,971721,dust,0,51
1,972484,972777,AluSz,1,293
1,972484,972777,AluSz,1,293
1,974167,974237,dust,0,70
1,975096,975215,dust,0,119
1,975096,975178,trf,0,82
1,975096,975181,trf,0,85
1,975096,975199,trf,0,103
1,975100,975210,GA-rich,1,110
1,975106,975181,trf,0,75
1,975108,975180,trf,0,72
1,975795,975872,MER53,1,77
1,975795,975872,MER53,1,77
1,975917,975958,(CCCA)n,1,41
1,976671,977262,dust,0,591
1,976687,978077,trf,0,1390
1,976699,976882,C-rich,1,183
1,977046,977232,C-rich,1,186
1,977298,977484,C-rich,1,186
1,977302,977715,dust,0,413
1,977718,978061,dust,0,343
1,977872,978062,(CCCCAA)n,1,190
1,978074,978120,trf,0,46
1,978296,978326,trf,0,30
1,978367,978403,trf,0,36
1,979812,980141,trf,0,329
1,983096,983187,L1M5,-1,91
1,983096,983187,L1M5,-1,91
1,983336,983452,L1M5,-1,116
1,983336,983452,L1M5,-1,116
1,983456,983719,AluSq2,-1,263
1,983456,983719,AluSq2,-1,263
1,983732,983740,dust,0,8
1,983736,983863,L1M5,-1,127
1,984244,984268,dust,0,24
1,984575,984657,dust,0,82
1,984576,984607,trf,0,31
1,984581,984822,AluJb,-1,241
1,984612,984657,trf,0,45
1,984628,984822,AluJb,-1,194
1,984823,984860,L1ME1,-1,37
1,984861,984892,(TCTA)n,1,31
1,984894,985172,AluSz,-1,278
1,984894,985172,AluSz,-1,278
1,985173,985599,L1ME1,-1,426
1,985176,985599,L1ME1,-1,423
1,985600,986089,MER4A1_,1,489
1,985600,986089,MER4A1_,1,489
1,986090,986389,AluY,-1,299
1,986090,986389,AluY,-1,299
1,986098,986107,dust,0,9
1,986390,986445,MER4A1_,1,55
1,986390,986445,MER4A1_,1,55
1,986446,986775,L1ME1,-1,329
1,986446,986775,L1ME1,-1,329
1,986776,987071,AluSz,-1,295
1,986776,987071,AluSz,-1,295
1,987072,987084,L1ME1,-1,12
1,987072,987084,L1ME1,-1,12
1,987108,987241,AluSz,1,133
1,987108,987241,AluSz,1,133
1,987249,987283,L1ME1,-1,34
1,987249,987283,L1ME1,-1,34
1,987284,987580,AluSq,-1,296
1,987284,987580,AluSq,-1,296
1,987287,987302,dust,0,15
1,987581,987654,L1ME1,-1,73
1,987581,987654,L1ME1,-1,73
1,987655,987959,AluSx1,-1,304
1,987655,987959,AluSx1,-1,304
1,987960,988305,L1ME1,-1,345
1,987960,988305,L1ME1,-1,345
1,988020,988047,dust,0,27
1,988306,988614,AluSg,1,308
1,988306,988614,AluSg,1,308
1,988586,988619,dust,0,33
1,988587,988621,trf,0,34
1,988588,988619,trf,0,31
1,988615,988694,L1ME1,-1,79
1,988615,988694,L1ME1,-1,79
1,988687,989365,trf,0,678
1,989357,989508,L1MEc,-1,151
1,989357,989508,L1MEc,-1,151
1,989509,989864,MSTD,-1,355
1,989509,989864,MSTD,-1,355
1,989865,989985,L1MEc,-1,120
1,989865,989985,L1MEc,-1,120
1,989984,990013,dust,0,29
1,989986,990297,AluSx1,-1,311
1,989986,990297,AluSx1,-1,311
1,990299,990536,AluSq2,-1,237
1,990299,990311,dust,0,12
1,990299,990536,AluSq2,-1,237
1,990537,990718,L1MEc,-1,181
1,990537,990718,L1MEc,-1,181
1,990719,990994,AluSx1,1,275
1,990719,990994,AluSx1,1,275
1,990996,991175,L1MEc,-1,179
1,990996,991175,L1MEc,-1,179
1,991176,991489,AluJb,-1,313
1,991176,991489,AluJb,-1,313
1,991342,991362,dust,0,20
1,991490,991514,L1MEc,-1,24
1,991498,991544,dust,0,46
1,991499,991825,AluSx,-1,326
1,991510,991543,trf,0,33
1,991515,991825,AluSp,-1,310
1,991826,991915,L1MEc,-1,89
1,991826,991915,L1MEc,-1,89
1,991966,992151,L1MEc,-1,185
1,991966,992130,L1MEc,-1,164
1,992131,992469,AluSx,-1,338
1,992142,992178,dust,0,36
1,992151,992178,trf,0,27
1,992152,992469,AluSx1,-1,317
1,992325,992352,dust,0,27
1,992470,992655,L1MEc,-1,185
1,992470,992655,L1MEc,-1,185
1,992474,992522,dust,0,48
1,992697,992744,FRAM,-1,47
1,992697,992744,FRAM,-1,47
1,992744,992794,FRAM,-1,50
1,992744,992794,FRAM,-1,50
1,992884,993152,trf,0,268
1,992891,993152,trf,0,261
1,993589,993633,dust,0,44
1,993731,994041,MSTA,1,310
1,993731,994041,MSTA,1,310
1,994042,994334,AluSz,1,292
1,994042,994334,AluSz,1,292
1,994322,994334,dust,0,12
1,994335,994401,MSTA,1,66
1,994335,994401,MSTA,1,66
1,994402,994667,AluSx,-1,265
1,994402,994667,AluSx,-1,265
1,994668,994730,L1M4,1,62
1,994668,994730,L1M4,1,62
1,994735,994791,AluYc,1,56
1,994735,994791,AluYc,1,56
1,994783,994791,dust,0,8
1,994810,994873,L1MEc,1,63
1,994810,994873,L1MEc,1,63
1,995068,995364,AluSx1,1,296
1,995068,995364,AluSx1,1,296
1,995381,995512,L1MEc,1,131
1,995381,995512,L1MEc,1,131
1,995509,995521,dust,0,12
1,995780,995844,(CCCCAG)n,1,64
1,996255,996867,trf,0,612
1,997105,997178,L2b,-1,73
1,997105,997178,L2b,-1,73
1,997611,997731,trf,0,120
1,998362,998390,GC_rich,1,28
1,998703,998783,G-rich,1,80
1,998713,998776,dust,0,63
1,998744,998784,trf,0,40
1,998804,998844,dust,0,40
1,998804,998844,GC_rich,1,40
1,999087,999132,GC_rich,1,45
1,999481,999528,dust,0,47
1,999810,999863,dust,0,53
